,state,county,num_hosp,num_not_hosp,num_infected,percent_hosp
0,VA,BEDFORD,250,2856,3106,0.08048937540244688
1,VA,CHARLOTTESVILLE CITY,112,3185,3297,0.03397027600849257
2,NC,IREDELL,430,7195,7625,0.05639344262295082
3,PA,NORTHUMBERLAND,355,1863,2218,0.1600541027953111
4,OH,BUTLER,1761,21099,22860,0.07703412073490813
5,VA,NEWPORT NEWS CITY,528,6689,7217,0.0731605930442012
6,CT,NEW HAVEN,4700,8735,13435,0.34983252698176404
7,PA,MERCER,301,2644,2945,0.10220713073005093
8,TN,LAWRENCE,141,2054,2195,0.0642369020501139
9,TN,CLAIBORNE,65,809,874,0.07437070938215103
10,TN,COCKE,100,1420,1520,0.06578947368421052
11,GA,BRYAN,55,83,138,0.39855072463768115
12,ID,BANNOCK,411,7014,7425,0.055353535353535356
13,AZ,COCONINO,1439,8695,10134,0.14199723702388
14,OK,MCCURTAIN,303,2636,2939,0.10309629125552909
15,CA,RIVERSIDE,7744,88918,96662,0.08011421241025429
16,IL,WINNEBAGO,1130,9345,10475,0.10787589498806682
17,OH,GEAUGA,373,1224,1597,0.23356293049467752
18,NY,LIVINGSTON,12,192,204,0.058823529411764705
19,PA,WAYNE,90,911,1001,0.0899100899100899
20,GA,EMANUEL,16,26,42,0.38095238095238093
21,OR,DOUGLAS,360,3327,3687,0.09764035801464606
22,PA,MCKEAN,130,1243,1373,0.09468317552804079
23,OH,BROWN,54,360,414,0.13043478260869565
24,AL,NA,1479,13136,14615,0.10119739993157714
25,KS,SUMNER,127,1482,1609,0.07893101305158484
26,WI,MARATHON,767,12684,13451,0.05702178276708052
27,OK,OKMULGEE,321,2697,3018,0.10636182902584493
28,NC,ALAMANCE,1030,13364,14394,0.07155759344171182
29,IN,LAWRENCE,43,1067,1110,0.03873873873873874
30,MI,JACKSON,374,5984,6358,0.058823529411764705
31,OK,MUSKOGEE,758,4901,5659,0.13394592684219828
32,AL,BARBOUR,68,626,694,0.09798270893371758
33,IN,PUTNAM,21,152,173,0.12138728323699421
34,WY,NA,112,843,955,0.11727748691099477
35,WI,GREEN,166,2474,2640,0.06287878787878788
36,MI,MIDLAND,312,5378,5690,0.05483304042179262
37,IL,DUPAGE,6304,60004,66308,0.09507148458707848
38,OK,WOODWARD,136,1247,1383,0.09833694866232827
39,MI,DICKINSON,51,1534,1585,0.032176656151419555
40,SC,FLORENCE,1228,11410,12638,0.09716727330273778
41,KY,NA,3316,55133,58449,0.056733220414378345
42,NC,JOHNSTON,673,12990,13663,0.04925711776330235
43,TN,WILSON,325,6083,6408,0.05071785268414482
44,SC,BERKELEY,452,9982,10434,0.04331991566034119
45,TN,SUMNER,701,6111,6812,0.10290663534938344
46,FL,WAKULLA,106,1398,1504,0.07047872340425532
47,WI,DUNN,152,2215,2367,0.06421630756231517
48,SC,FAIRFIELD,145,1359,1504,0.09640957446808511
49,MA,NORFOLK,1928,11332,13260,0.14539969834087482
50,MN,WABASHA,76,101,177,0.4293785310734463
51,CO,MESA,809,9017,9826,0.08233258701404438
52,GA,EFFINGHAM,65,109,174,0.3735632183908046
53,OH,JACKSON,198,2545,2743,0.07218374043018592
54,AR,BOONE,138,2076,2214,0.06233062330623306
55,OK,GARVIN,237,2510,2747,0.08627593738623954
56,OH,FULTON,238,2596,2834,0.0839802399435427
57,ID,TWIN FALLS,772,6408,7180,0.1075208913649025
58,MN,DAKOTA,2564,1166,3730,0.6873994638069705
59,NY,CHEMUNG,15,76,91,0.16483516483516483
60,NJ,GLOUCESTER,3825,16928,20753,0.184310702067171
61,AR,POPE,423,4674,5097,0.08298999411418481
62,ID,BINGHAM,290,3768,4058,0.07146377525874816
63,IN,WARRICK,34,602,636,0.05345911949685535
64,GA,DEKALB,444,431,875,0.5074285714285715
65,GA,FULTON,290,424,714,0.4061624649859944
66,GA,JACKSON,95,407,502,0.1892430278884462
67,MI,LAPEER,422,4126,4548,0.09278803869832894
68,AZ,PINAL,5396,20195,25591,0.2108553788441249
69,CO,TELLER,134,1121,1255,0.10677290836653386
70,TN,DYER,108,2312,2420,0.04462809917355372
71,GA,BARROW,117,357,474,0.2468354430379747
72,GA,LOWNDES,120,409,529,0.22684310018903592
73,VA,HENRY,371,3120,3491,0.10627327413348611
74,NC,WILSON,870,7041,7911,0.10997345468335229
75,ID,CASSIA,106,1799,1905,0.05564304461942257
76,FL,SANTA ROSA,586,9543,10129,0.05785368743212558
77,PA,SNYDER,220,963,1183,0.18596787827557057
78,SC,CHESTERFIELD,307,3109,3416,0.0898711943793911
79,NC,ROWAN,624,7645,8269,0.07546257104849438
80,IN,KNOX,72,135,207,0.34782608695652173
81,VA,SPOTSYLVANIA,320,4197,4517,0.07084348018596413
82,WA,ISLAND,104,1737,1841,0.056491037479630635
83,AR,BAXTER,212,1499,1711,0.12390414962010521
84,SC,CHARLESTON,1053,22698,23751,0.04433497536945813
85,WA,KITSAP,384,8465,8849,0.0433947338682337
86,OH,COLUMBIANA,497,3348,3845,0.12925877763329
87,VA,FAIRFAX,4061,65381,69442,0.05848045851213963
88,OH,JEFFERSON,261,2938,3199,0.08158799624882776
89,FL,COLLIER,1116,16222,17338,0.06436728573076479
90,PA,CUMBERLAND,498,3635,4133,0.12049358819259617
91,IL,LIVINGSTON,80,537,617,0.12965964343598055
92,GA,CHATTOOGA,1,3,4,0.25
93,MA,BARNSTABLE,492,4046,4538,0.10841780520052886
94,AR,WHITE,234,3435,3669,0.06377759607522486
95,IA,STORY,61,3074,3135,0.01945773524720893
96,IN,FLOYD,166,791,957,0.17345872518286312
97,WA,BENTON,942,17125,18067,0.052139259423257873
98,MI,MENOMINEE,81,1165,1246,0.06500802568218299
99,FL,BRADFORD,120,2337,2457,0.04884004884004884
100,KS,MCPHERSON,183,2595,2778,0.06587473002159827
101,CA,FRESNO,4219,48358,52577,0.08024421324913936
102,KY,DAVIESS,237,6081,6318,0.03751187084520418
103,KY,OLDHAM,132,1822,1954,0.06755373592630501
104,PA,MONROE,368,3832,4200,0.08761904761904762
105,TN,MARSHALL,71,1501,1572,0.045165394402035625
106,IL,KANKAKEE,428,1959,2387,0.1793045664013406
107,IA,LEE,33,805,838,0.03937947494033413
108,ID,LATAH,36,2120,2156,0.016697588126159554
109,IN,KOSCIUSKO,30,151,181,0.16574585635359115
110,OH,GALLIA,139,2045,2184,0.06364468864468864
111,NC,DUPLIN,378,5437,5815,0.06500429922613929
112,FL,WALTON,225,2991,3216,0.06996268656716417
113,NV,CLARK,18255,152141,170396,0.10713279654451982
114,VA,DINWIDDIE,93,1015,1108,0.08393501805054152
115,PA,JEFFERSON,68,752,820,0.08292682926829269
116,MS,HINDS,428,2101,2529,0.16923685251087386
117,NC,DAVIDSON,557,5871,6428,0.08665214685749845
118,CO,LA PLATA,155,2884,3039,0.05100361961171438
119,NY,ALBANY,401,2093,2494,0.16078588612670408
120,IN,CLAY,40,29,69,0.5797101449275363
121,TN,HAMILTON,1000,19870,20870,0.04791566842357451
122,NC,WAKE,1220,33669,34889,0.034968041503052535
123,MD,CECIL,534,3607,4141,0.1289543588505192
124,NJ,MORRIS,5100,29087,34187,0.14917951268025859
125,CA,SACRAMENTO,5316,29097,34413,0.1544765059715805
126,MD,BALTIMORE CITY,343,1135,1478,0.23207036535859268
127,NY,ALLEGANY,1,4,5,0.2
128,IA,POLK,500,13650,14150,0.0353356890459364
129,WI,CHIPPEWA,244,3370,3614,0.06751521859435529
130,MI,INGHAM,904,8679,9583,0.09433371595533757
131,WI,ROCK,870,11293,12163,0.07152840582093234
132,PA,DELAWARE,2677,21317,23994,0.11156955905643078
133,MN,MILLE LACS,238,99,337,0.7062314540059347
134,CO,EL PASO,3486,14777,18263,0.19087773093139135
135,IA,MARION,62,956,1018,0.060903732809430254
136,AL,MONROE,36,419,455,0.07912087912087912
137,IA,WAPELLO,149,1506,1655,0.09003021148036254
138,VA,CAMPBELL,209,2182,2391,0.08741112505227938
139,VA,ROANOKE,190,3545,3735,0.050870147255689425
140,NC,HENDERSON,300,6137,6437,0.046605561597017245
141,IA,LINN,460,5307,5767,0.07976417548118606
142,SC,CHESTER,194,2202,2396,0.08096828046744574
143,NY,CHENANGO,23,102,125,0.184
144,IL,PERRY,120,1975,2095,0.057279236276849645
145,NE,ADAMS,0,1,1,0.0
146,OK,LINCOLN,231,1936,2167,0.1065989847715736
147,OR,LINCOLN,69,1193,1262,0.05467511885895404
148,OH,CARROLL,131,1389,1520,0.0861842105263158
149,OH,MUSKINGUM,638,7229,7867,0.0810982585483666
150,WA,MASON,126,2787,2913,0.04325437693099897
151,VA,ROCKBRIDGE,57,909,966,0.059006211180124224
152,OH,OTTAWA,247,1964,2211,0.1117141564902759
153,TN,BRADLEY,539,5071,5610,0.09607843137254903
154,MN,FILLMORE,62,72,134,0.4626865671641791
155,TN,GILES,93,1254,1347,0.06904231625835189
156,IL,KNOX,150,1378,1528,0.09816753926701571
157,FL,PALM BEACH,4972,67440,72412,0.06866265259901674
158,SC,PICKENS,547,9310,9857,0.0554935578776504
159,CA,STANISLAUS,2935,23410,26345,0.11140633896375024
160,IN,DAVIESS,59,74,133,0.44360902255639095
161,CA,HUMBOLDT,231,3776,4007,0.05764911405041178
162,IL,LASALLE,357,2555,2912,0.12259615384615384
163,PA,MIFFLIN,49,672,721,0.06796116504854369
164,NC,NEW HANOVER,405,10818,11223,0.03608660785886127
165,AR,POINSETT,288,1825,2113,0.1362991008045433
166,AL,DALE,84,1335,1419,0.05919661733615222
167,MN,BELTRAMI,234,50,284,0.823943661971831
168,MI,BERRIEN,775,6374,7149,0.10840677017764723
169,VA,SUFFOLK CITY,467,5317,5784,0.08073997233748272
170,CO,DENVER,4422,18018,22440,0.19705882352941176
171,UT,WASHINGTON,329,20052,20381,0.016142485648398017
172,CA,MADERA,529,8431,8960,0.05904017857142857
173,MD,ANNE ARUNDEL,263,1247,1510,0.1741721854304636
174,PA,SOMERSET,239,1299,1538,0.1553966189856957
175,VA,HALIFAX,76,854,930,0.08172043010752689
176,IN,POSEY,3,140,143,0.02097902097902098
177,RI,BRISTOL,7,22,29,0.2413793103448276
178,TN,SULLIVAN,725,6416,7141,0.10152639686318443
179,OH,ASHTABULA,409,566,975,0.4194871794871795
180,GA,GILMER,8,6,14,0.5714285714285714
181,PA,CENTRE,232,3997,4229,0.05485930480018917
182,NJ,BERGEN,11113,53594,64707,0.1717433971595036
183,IL,JACKSON,180,1823,2003,0.08986520219670495
184,NJ,CAMDEN,7091,31968,39059,0.18154586650963928
185,CO,BOULDER,863,9296,10159,0.08494930603405847
186,NM,CIBOLA,246,662,908,0.2709251101321586
187,AL,TALLADEGA,186,2253,2439,0.07626076260762607
188,NJ,OCEAN,8158,41034,49192,0.16583997397950886
189,CO,LARIMER,1188,1877,3065,0.38760195758564436
190,NY,DUTCHESS,334,769,1103,0.3028105167724388
191,IN,MONROE,31,299,330,0.09393939393939393
192,KS,LEAVENWORTH,352,4556,4908,0.07171964140179299
193,PA,WASHINGTON,500,4038,4538,0.11018069634200088
194,OK,OTTAWA,187,2750,2937,0.06367041198501873
195,NJ,HUDSON,9205,42495,51700,0.17804642166344295
196,NC,COLUMBUS,424,4340,4764,0.08900083963056256
197,IA,MUSCATINE,125,1289,1414,0.0884016973125884
198,GA,PUTNAM,39,145,184,0.21195652173913043
199,NM,SAN MIGUEL,120,92,212,0.5660377358490566
200,GA,HARRIS,20,18,38,0.5263157894736842
201,FL,BROWARD,7968,148354,156322,0.05097171223500211
202,KS,MIAMI,207,2066,2273,0.09106907171139464
203,ND,BURLEIGH,172,3613,3785,0.04544253632760898
204,KY,HARLAN,123,905,1028,0.11964980544747082
205,TN,CARROLL,74,1409,1483,0.049898853674983146
206,MO,BOONE,1,4,5,0.2
207,UT,IRON,44,5775,5819,0.007561436672967864
208,NC,BUNCOMBE,576,10727,11303,0.05095992214456339
209,OH,PICKAWAY,323,3512,3835,0.08422425032594524
210,SC,WILLIAMSBURG,293,2691,2984,0.09819034852546916
211,MD,DORCHESTER,101,2362,2463,0.04100690215184734
212,TN,SHELBY,3502,30498,34000,0.103
213,CA,MONTEREY,1449,17865,19314,0.0750232991612302
214,GA,CHEROKEE,224,149,373,0.6005361930294906
215,NC,SAMPSON,451,6503,6954,0.06485475985044578
216,SC,LAURENS,287,3205,3492,0.08218785796105384
217,AR,WASHINGTON,904,16764,17668,0.051165949739642294
218,VT,WASHINGTON,48,1621,1669,0.028759736369083282
219,FL,CHARLOTTE,550,6452,7002,0.07854898600399886
220,VA,SMYTH,200,1992,2192,0.09124087591240876
221,MN,WINONA,52,164,216,0.24074074074074073
222,OH,HURON,361,4414,4775,0.07560209424083769
223,NY,OSWEGO,14,84,98,0.14285714285714285
224,TN,HAWKINS,143,2075,2218,0.06447249774571687
225,IL,IROQUOIS,133,302,435,0.3057471264367816
226,MI,SHIAWASSEE,189,2903,3092,0.0611254851228978
227,IN,RANDOLPH,29,162,191,0.1518324607329843
228,VA,CAROLINE,69,947,1016,0.06791338582677166
229,NY,ORANGE,1989,23432,25421,0.0782423980173872
230,IA,CARROLL,56,1053,1109,0.05049594229035167
231,IN,MARION,1972,3339,5311,0.37130483901336847
232,NY,ESSEX,8,37,45,0.17777777777777778
233,UT,UINTAH,14,2808,2822,0.004961020552799433
234,IN,ELKHART,226,458,684,0.3304093567251462
235,TN,ROBERTSON,409,3439,3848,0.10628898128898129
236,PA,LEBANON,710,2915,3625,0.19586206896551725
237,OH,TRUMBULL,1216,9611,10827,0.11231181305994274
238,IN,JEFFERSON,4,53,57,0.07017543859649122
239,IA,JASPER,48,1046,1094,0.043875685557586835
240,IA,SIOUX,78,1967,2045,0.038141809290953545
241,WI,BROWN,1439,20985,22424,0.06417231537638245
242,VA,RUSSELL,131,1658,1789,0.07322526551145891
243,NV,ELKO,321,4222,4543,0.07065815540391812
244,TX,BEXAR,0,8,8,0.0
245,DE,NA,2,18,20,0.1
246,IL,MCLEAN,687,6229,6916,0.09933487565066512
247,OH,WOOD,656,7324,7980,0.08220551378446116
248,WI,WOOD,289,3411,3700,0.0781081081081081
249,KY,CALLOWAY,94,2833,2927,0.03211479330372395
250,AZ,NAVAJO,1875,5002,6877,0.27264795695797583
251,NJ,PASSAIC,8387,42123,50510,0.16604632745990894
252,NM,SANTA FE,629,1054,1683,0.37373737373737376
253,NY,ONEIDA,121,669,790,0.15316455696202533
254,RI,NEWPORT,7,52,59,0.11864406779661017
255,GA,BULLOCH,48,31,79,0.6075949367088608
256,CT,NA,133,697,830,0.1602409638554217
257,NJ,NA,322,2157,2479,0.12989108511496572
258,AR,MISSISSIPPI,444,3392,3836,0.11574556830031282
259,NY,ERIE,1124,2493,3617,0.3107547691457009
260,NH,STRAFFORD,94,5285,5379,0.0174753671686187
261,OH,FRANKLIN,3957,65068,69025,0.057327055414704814
262,WI,ONEIDA,184,1378,1562,0.117797695262484
263,ME,YORK,386,9835,10221,0.03776538499168379
264,MN,ST. LOUIS,1100,448,1548,0.710594315245478
265,NY,HERKIMER,19,94,113,0.168141592920354
266,GA,ROCKDALE,17,12,29,0.5862068965517241
267,WV,NA,33,72,105,0.3142857142857143
268,WI,DOUGLAS,167,3284,3451,0.04839177050130397
269,AL,MARION,82,867,949,0.08640674394099052
270,FL,SUWANNEE,234,3584,3818,0.061288632792037716
271,CA,GLENN,146,1518,1664,0.08774038461538461
272,WA,CLARK,1431,24650,26081,0.05486752808557954
273,KS,LYON,254,3568,3822,0.06645735217163788
274,CO,ROUTT,38,1651,1689,0.022498519834221433
275,VA,PORTSMOUTH CITY,684,4484,5168,0.1323529411764706
276,RI,WASHINGTON,13,67,80,0.1625
277,UT,CACHE,32,16590,16622,0.0019251594272650704
278,CO,MORGAN,263,847,1110,0.23693693693693693
279,IL,CHRISTIAN,89,340,429,0.20745920745920746
280,VA,ORANGE,77,1373,1450,0.05310344827586207
281,IL,MARION,137,354,491,0.2790224032586558
282,NY,FRANKLIN,1,14,15,0.06666666666666667
283,NY,QUEENS,35217,4863,40080,0.8786676646706587
284,ND,NA,451,6195,6646,0.0678603671381282
285,IL,FAYETTE,142,2621,2763,0.051393412956930874
286,MS,FORREST,122,754,876,0.13926940639269406
287,NC,MARTIN,222,1148,1370,0.16204379562043797
288,NC,ROCKINGHAM,468,5440,5908,0.07921462423832092
289,IL,COLES,304,839,1143,0.2659667541557305
290,WI,LA CROSSE,422,2829,3251,0.1298062134727776
291,OH,ASHLAND,297,3052,3349,0.08868318901164526
292,MN,SHERBURNE,504,387,891,0.5656565656565656
293,IN,NOBLE,13,97,110,0.11818181818181818
294,FL,DUVAL,1772,22739,24511,0.072294072049284
295,FL,HENDRY,266,2820,3086,0.08619572261827609
296,WI,VILAS,117,1403,1520,0.07697368421052632
297,WI,CLARK,242,2823,3065,0.07895595432300163
298,NC,BURKE,196,4238,4434,0.04420387911592242
299,OH,MEDINA,747,7113,7860,0.0950381679389313
300,WI,TREMPEALEAU,116,1362,1478,0.07848443843031123
301,VA,SALEM CITY,74,949,1023,0.07233626588465299
302,VA,RICHMOND CITY,827,8607,9434,0.0876616493534026
303,OR,COOS,154,1852,2006,0.07676969092721835
304,WI,WALWORTH,420,3773,4193,0.1001669449081803
305,AL,LAUDERDALE,151,2674,2825,0.05345132743362832
306,IN,RIPLEY,12,42,54,0.2222222222222222
307,RI,PROVIDENCE,93,494,587,0.15843270868824533
308,NY,NEW YORK,16669,3540,20209,0.8248305210549755
309,MA,MIDDLESEX,4904,38121,43025,0.11398024404416038
310,SD,MINNEHAHA,1,5,6,0.16666666666666666
311,WA,SKAGIT,352,5673,6025,0.058423236514522824
312,WA,OKANOGAN,184,2603,2787,0.06602081090778615
313,OK,SEQUOYAH,223,2467,2690,0.0828996282527881
314,ME,KENNEBEC,171,4610,4781,0.03576657603011922
315,TN,LINCOLN,62,1211,1273,0.04870384917517675
316,TN,FAYETTE,130,1961,2091,0.06217120994739359
317,FL,HIGHLANDS,455,4561,5016,0.0907097288676236
318,OH,WARREN,744,8322,9066,0.08206485771012574
319,NJ,MONMOUTH,8242,44487,52729,0.15630867264693052
320,AL,TUSCALOOSA,480,6358,6838,0.0701959637320854
321,OH,MERCER,398,3744,4142,0.09608884596813133
322,OH,DEFIANCE,290,3810,4100,0.07073170731707316
323,ND,CASS,139,4794,4933,0.028177579566186904
324,OH,HIGHLAND,195,835,1030,0.18932038834951456
325,GA,WALTON,50,50,100,0.5
326,TN,OBION,91,1875,1966,0.04628687690742624
327,AZ,NA,375,1471,1846,0.20314192849404117
328,GA,PEACH,21,34,55,0.38181818181818183
329,GA,TROUP,64,141,205,0.3121951219512195
330,IA,JOHNSON,145,4138,4283,0.033854774690637406
331,WA,PIERCE,3634,53508,57142,0.06359595393930909
332,TN,MADISON,316,3203,3519,0.08979823813583404
333,NM,MCKINLEY,1800,2968,4768,0.3775167785234899
334,NY,SCHENECTADY,183,635,818,0.2237163814180929
335,IL,CHAMPAIGN,174,2177,2351,0.07401105912377712
336,PA,BERKS,978,10297,11275,0.08674057649667406
337,NC,CABARRUS,731,10243,10974,0.06661199198104611
338,VA,WISE,170,2191,2361,0.07200338839474799
339,NC,EDGECOMBE,391,2982,3373,0.11592054550844945
340,AR,NA,3700,32320,36020,0.10272071071626875
341,NY,RENSSELAER,345,2840,3185,0.10832025117739404
342,VA,KING GEORGE,63,613,676,0.09319526627218935
343,GA,CLARKE,80,261,341,0.23460410557184752
344,MI,KENT,1664,33965,35629,0.046703528024923516
345,GA,DECATUR,19,73,92,0.20652173913043478
346,NE,MADISON,1,0,1,1.0
347,NC,TRANSYLVANIA,90,1599,1689,0.05328596802841918
348,SC,GREENVILLE,2234,33036,35270,0.06333994896512617
349,AZ,YUMA,2301,16796,19097,0.12049012933968686
350,TN,WARREN,77,2008,2085,0.036930455635491605
351,AL,LIMESTONE,172,2973,3145,0.05468998410174881
352,VI,NA,127,2302,2429,0.052284890901605596
353,IL,HENRY,110,897,1007,0.10923535253227408
354,ID,MADISON,95,5175,5270,0.018026565464895637
355,AL,RANDOLPH,54,531,585,0.09230769230769231
356,TN,HAMBLEN,218,2738,2956,0.07374830852503383
357,GA,CARROLL,18,22,40,0.45
358,MA,NA,72,657,729,0.09876543209876543
359,OK,STEPHENS,389,3566,3955,0.09835651074589127
360,VA,YORK,86,1763,1849,0.046511627906976744
361,WA,YAKIMA,1615,29177,30792,0.052448687970901534
362,OR,WASCO,58,1116,1174,0.049403747870528106
363,FL,LEON,482,12124,12606,0.038235760748849754
364,OK,LOGAN,220,2262,2482,0.088638195004029
365,VT,WINDHAM,42,1062,1104,0.03804347826086957
366,NY,SUFFOLK,1183,775,1958,0.6041879468845761
367,IL,WILLIAMSON,318,371,689,0.46153846153846156
368,NC,PITT,465,8106,8571,0.054252712635631785
369,WI,WAUKESHA,2184,19826,22010,0.09922762380736029
370,NC,PENDER,163,1700,1863,0.08749329039184112
371,CO,DOUGLAS,1160,8535,9695,0.11964930376482723
372,WI,TAYLOR,68,1073,1141,0.05959684487291849
373,ID,PAYETTE,126,1928,2054,0.06134371957156767
374,VA,NORFOLK CITY,1048,10048,11096,0.09444844989185291
375,OH,RICHLAND,646,5771,6417,0.10067009505999688
376,CA,CONTRA COSTA,6879,36441,43320,0.1587950138504155
377,IN,SCOTT,19,128,147,0.1292517006802721
378,MI,EMMET,74,1513,1587,0.04662885948330183
379,MA,HAMPDEN,1802,8166,9968,0.1807784911717496
380,IN,CARROLL,23,153,176,0.13068181818181818
381,MN,OLMSTED,624,748,1372,0.45481049562682213
382,AL,CULLMAN,136,2372,2508,0.05422647527910686
383,MN,BROWN,145,106,251,0.5776892430278885
384,WA,GRANT,466,9396,9862,0.04725207868586494
385,OH,MAHONING,1071,7571,8642,0.12392964591529738
386,NC,POLK,67,1065,1132,0.05918727915194346
387,NM,LUNA,177,262,439,0.4031890660592255
388,NY,STEUBEN,38,186,224,0.16964285714285715
389,IN,WHITLEY,17,52,69,0.2463768115942029
390,OH,LICKING,358,4585,4943,0.07242565243779081
391,TN,DEKALB,51,985,1036,0.04922779922779923
392,MA,BERKSHIRE,249,1474,1723,0.1445153801508996
393,IL,MACON,539,4040,4579,0.11771129067481984
394,AL,CHEROKEE,33,451,484,0.06818181818181818
395,GA,NA,1075,2227,3302,0.3255602665051484
396,WA,COWLITZ,344,6319,6663,0.051628395617589674
397,NC,RUTHERFORD,295,3297,3592,0.08212694877505568
398,PA,LAWRENCE,203,2173,2376,0.08543771043771044
399,AR,YELL,172,2057,2229,0.07716464782413639
400,GA,FANNIN,14,12,26,0.5384615384615384
401,MO,ST. LOUIS CITY,4,1,5,0.8
402,MI,TUSCOLA,278,2724,3002,0.09260493004663557
403,IL,KENDALL,690,3601,4291,0.1608016779305523
404,MI,OSCEOLA,83,939,1022,0.0812133072407045
405,CA,SAN BENITO,269,3568,3837,0.07010685431326558
406,IL,STEPHENSON,148,1274,1422,0.10407876230661041
407,TN,FRANKLIN,98,1742,1840,0.05326086956521739
408,KY,PIKE,95,2161,2256,0.04210992907801418
409,OK,CARTER,272,3878,4150,0.0655421686746988
410,OH,CLARK,515,7913,8428,0.06110583768391077
411,VA,ALBEMARLE,252,4218,4470,0.056375838926174496
412,UT,TOOELE,25,6992,7017,0.003562776115148924
413,WI,ST. CROIX,316,5488,5804,0.05444521019986216
414,VA,HENRICO,1113,13306,14419,0.07718981898883417
415,SC,YORK,954,16307,17261,0.05526910375992121
416,MD,QUEEN ANNE'S,134,2168,2302,0.05821025195482189
417,FL,HARDEE,167,2348,2515,0.06640159045725647
418,NH,COOS,13,855,868,0.014976958525345621
419,NC,ASHE,40,1476,1516,0.026385224274406333
420,OH,ADAMS,149,1448,1597,0.09329993738259236
421,GA,HENRY,35,57,92,0.3804347826086957
422,AZ,PIMA,8701,50849,59550,0.14611251049538204
423,TN,WASHINGTON,352,5814,6166,0.05708725267596497
424,TN,MCMINN,146,2441,2587,0.056436026285272514
425,OH,MONTGOMERY,4784,27634,32418,0.14757233635634523
426,MS,LAUDERDALE,188,798,986,0.19066937119675456
427,NY,YATES,4,29,33,0.12121212121212122
428,OR,NA,399,5148,5547,0.07193077339102218
429,NJ,ATLANTIC,3922,19856,23778,0.16494238371604003
430,AR,CLEBURNE,132,872,1004,0.13147410358565736
431,OR,LANE,804,9573,10377,0.07747904018502458
432,CA,SANTA CLARA,5950,85492,91442,0.06506856805406706
433,CT,TOLLAND,158,1554,1712,0.09228971962616822
434,AR,SALINE,580,6340,6920,0.0838150289017341
435,IA,BENTON,34,599,633,0.053712480252764615
436,GA,PAULDING,17,17,34,0.5
437,GU,NA,311,2103,2414,0.12883181441590721
438,OH,NA,1081,7557,8638,0.12514470942347766
439,WA,SNOHOMISH,2533,37979,40512,0.06252468404423381
440,NH,BELKNAP,52,1789,1841,0.028245518739815317
441,OK,WAGONER,626,4871,5497,0.11388029834455157
442,KY,FLOYD,176,2496,2672,0.0658682634730539
443,NC,BLADEN,224,2520,2744,0.08163265306122448
444,OH,LOGAN,190,2220,2410,0.07883817427385892
445,IL,JERSEY,30,134,164,0.18292682926829268
446,MD,HARFORD,124,1312,1436,0.08635097493036212
447,GA,SPALDING,119,73,192,0.6197916666666666
448,VA,PAGE,114,1072,1186,0.09612141652613827
449,MT,SILVER BOW,115,3643,3758,0.030601383714741883
450,CA,SOLANO,1274,17286,18560,0.06864224137931034
451,VA,ACCOMACK,212,2435,2647,0.08009066868152626
452,WI,WAUPACA,248,2576,2824,0.08781869688385269
453,GA,LEE,44,64,108,0.4074074074074074
454,OH,LAKE,831,9264,10095,0.08231797919762258
455,TN,ROANE,132,1926,2058,0.0641399416909621
456,NY,TOMPKINS,12,135,147,0.08163265306122448
457,NM,CHAVES,457,909,1366,0.33455344070278187
458,GA,LAURENS,11,6,17,0.6470588235294118
459,MN,MORRISON,260,128,388,0.6701030927835051
460,GA,GORDON,28,87,115,0.24347826086956523
461,KY,WHITLEY,181,3014,3195,0.0566510172143975
462,UT,WASATCH,55,4602,4657,0.01181017822632596
463,MT,LAKE,120,1610,1730,0.06936416184971098
464,NC,MADISON,59,1200,1259,0.04686258935663225
465,ID,MINIDOKA,102,1374,1476,0.06910569105691057
466,IN,ADAMS,23,53,76,0.3026315789473684
467,AL,CHILTON,115,1432,1547,0.07433742727860375
468,IA,CLINTON,61,1259,1320,0.04621212121212121
469,MO,ST. CHARLES,0,2,2,0.0
470,OK,ROGERS,649,5909,6558,0.09896309850564196
471,OH,ERIE,718,5479,6197,0.11586251411973536
472,KS,POTTAWATOMIE,110,1349,1459,0.07539410555174778
473,MI,HURON,154,2462,2616,0.058868501529051986
474,MI,ANTRIM,61,958,1019,0.05986261040235525
475,IN,JAY,61,173,234,0.2606837606837607
476,AL,LAWRENCE,74,824,898,0.08240534521158129
477,MN,NICOLLET,98,214,312,0.3141025641025641
478,GA,DOUGHERTY,264,205,469,0.5628997867803838
479,GA,FORSYTH,182,259,441,0.4126984126984127
480,WA,WHITMAN,125,4142,4267,0.02929458636044059
481,MI,GLADWIN,113,1108,1221,0.09254709254709255
482,KY,BULLITT,206,4159,4365,0.047193585337915234
483,NJ,SUSSEX,1475,9245,10720,0.13759328358208955
484,MA,SUFFOLK,3591,17340,20931,0.17156370933065787
485,MN,CARVER,408,414,822,0.49635036496350365
486,UT,DAVIS,618,39794,40412,0.015292487379986142
487,CA,ORANGE,10754,100058,110812,0.09704725120023103
488,WI,ADAMS,100,852,952,0.10504201680672269
489,NC,SURRY,294,5249,5543,0.053039870106440554
490,OH,CLINTON,163,2385,2548,0.06397174254317112
491,IN,MONTGOMERY,52,500,552,0.09420289855072464
492,NC,UNION,800,11845,12645,0.06326611308817714
493,GA,TATTNALL,26,35,61,0.4262295081967213
494,OH,CLERMONT,855,10162,11017,0.07760733411999637
495,NC,WATAUGA,63,3198,3261,0.019319227230910764
496,TX,HARRIS,1,11,12,0.08333333333333333
497,SC,JASPER,140,1277,1417,0.09880028228652082
498,OH,ROSS,565,3040,3605,0.15672676837725383
499,PA,CLINTON,91,795,886,0.10270880361173815
500,NY,ONONDAGA,240,1272,1512,0.15873015873015872
501,NV,WASHOE,2337,34841,37178,0.06285975576954113
502,OR,UNION,69,1196,1265,0.05454545454545454
503,TN,MARION,92,1042,1134,0.08112874779541446
504,AR,MILLER,144,1595,1739,0.08280621046578493
505,VA,GOOCHLAND,55,758,813,0.06765067650676507
506,TN,ANDERSON,186,2805,2991,0.062186559679037114
507,OR,LINN,218,4000,4218,0.051683262209578
508,MA,PLYMOUTH,1486,8615,10101,0.1471141471141471
509,FL,SEMINOLE,885,10135,11020,0.08030852994555354
510,KY,KNOX,91,3460,3551,0.025626584060827937
511,KS,BUTLER,323,4503,4826,0.06692913385826772
512,OH,DELAWARE,329,5354,5683,0.05789195847263769
513,TN,HENRY,73,1126,1199,0.060884070058381985
514,CA,NA,443,4048,4491,0.09864172790024493
515,FL,NA,910,15039,15949,0.05705686876920183
516,WI,NA,2354,24585,26939,0.08738260514495713
517,UT,WEBER,264,29719,29983,0.008804989494046626
518,ID,BONNEVILLE,763,10008,10771,0.0708383622690558
519,ID,JEFFERSON,172,2066,2238,0.07685433422698838
520,KY,GRAVES,246,3219,3465,0.070995670995671
521,IN,WABASH,16,111,127,0.12598425196850394
522,NC,CARTERET,85,2225,2310,0.0367965367965368
523,CO,WELD,2303,12634,14937,0.15418089308428734
524,IN,DUBOIS,42,148,190,0.22105263157894736
525,MN,BLUE EARTH,299,285,584,0.511986301369863
526,MN,GOODHUE,213,223,436,0.48853211009174313
527,SD,PENNINGTON,1,2,3,0.3333333333333333
528,HI,HONOLULU,0,1,1,0.0
529,NJ,SALEM,698,4397,5095,0.13699705593719333
530,NH,ROCKINGHAM,326,10996,11322,0.028793499381734675
531,OR,BENTON,64,2517,2581,0.02479659046881054
532,NC,ORANGE,297,6603,6900,0.043043478260869565
533,FL,OKALOOSA,484,10142,10626,0.045548654244306416
534,KS,WYANDOTTE,1343,14278,15621,0.08597400934639268
535,IL,MONTGOMERY,129,2202,2331,0.055341055341055344
536,VA,POWHATAN,64,918,982,0.06517311608961303
537,MD,CARROLL,485,1073,1558,0.31129653401797175
538,TX,HIDALGO,2,4,6,0.3333333333333333
539,NY,NA,197,468,665,0.2962406015037594
540,WI,CALUMET,275,3032,3307,0.08315693982461446
541,CA,MENDOCINO,330,3412,3742,0.08818813468733298
542,NC,MACON,116,2168,2284,0.050788091068301226
543,AK,ANCHORAGE,845,2514,3359,0.2515629651682048
544,GA,MITCHELL,50,61,111,0.45045045045045046
545,NY,SCHOHARIE,9,34,43,0.20930232558139536
546,GA,CATOOSA,4,13,17,0.23529411764705882
547,NY,MONROE,131,88,219,0.5981735159817352
548,WA,FRANKLIN,599,12304,12903,0.04642331240796714
549,KY,MEADE,97,1672,1769,0.054833239118145846
550,WI,JEFFERSON,427,5252,5679,0.07518929388976933
551,GA,MERIWETHER,7,55,62,0.11290322580645161
552,GA,BIBB,340,367,707,0.4809052333804809
553,MD,FREDERICK,47,281,328,0.14329268292682926
554,IL,ST. CLAIR,1163,7824,8987,0.12940914654500946
555,OR,COLUMBIA,100,1197,1297,0.07710100231303008
556,OK,COMANCHE,899,9888,10787,0.08334105868174654
557,NJ,SOMERSET,3054,14922,17976,0.16989319092122832
558,OH,SENECA,352,3574,3926,0.08965868568517575
559,OK,PITTSBURG,209,2681,2890,0.07231833910034602
560,NC,BEAUFORT,235,3490,3725,0.06308724832214765
561,GA,WASHINGTON,12,11,23,0.5217391304347826
562,VA,LEE,110,1444,1554,0.07078507078507079
563,PA,ADAMS,232,1838,2070,0.11207729468599034
564,MI,ALLEGAN,271,6242,6513,0.04160908951328113
565,AL,AUTAUGA,163,2055,2218,0.07348963029756538
566,IL,WOODFORD,110,123,233,0.4721030042918455
567,FL,LAKE,1237,9288,10525,0.11752969121140143
568,AR,LONOKE,425,3530,3955,0.10745891276864729
569,KY,LETCHER,93,1103,1196,0.07775919732441472
570,IA,SCOTT,313,5142,5455,0.05737855178735105
571,AL,JACKSON,81,1852,1933,0.04190377651319193
572,IN,DEARBORN,36,47,83,0.43373493975903615
573,IL,SANGAMON,992,3687,4679,0.21201111348578755
574,IN,CASS,41,53,94,0.43617021276595747
575,TX,GALVESTON,0,4,4,0.0
576,MS,NA,3170,19998,23168,0.13682665745856354
577,AR,CRAIGHEAD,952,8021,8973,0.1060960659757049
578,CA,MARIN,425,7034,7459,0.05697814720471913
579,OR,KLAMATH,290,2923,3213,0.0902583255524432
580,TN,GRAINGER,59,836,895,0.0659217877094972
581,FL,ST. LUCIE,1350,17072,18422,0.07328194549994571
582,TN,MONTGOMERY,297,5958,6255,0.04748201438848921
583,LA,EAST BATON ROUGE,84,438,522,0.16091954022988506
584,NJ,MERCER,5284,19495,24779,0.2132450865652367
585,MI,CASS,100,1603,1703,0.058719906048150326
586,KY,MADISON,337,6168,6505,0.05180630284396618
587,VA,FRANKLIN,194,2428,2622,0.07398932112890923
588,SC,OCONEE,294,5245,5539,0.053078172955407114
589,MN,ANOKA,2367,1171,3538,0.6690220463538722
590,MN,HUBBARD,112,103,215,0.5209302325581395
591,MN,DOUGLAS,196,67,263,0.7452471482889734
592,TN,SMITH,48,1009,1057,0.04541154210028382
593,PA,BEAVER,729,4607,5336,0.1366191904047976
594,NC,ROBESON,677,9526,10203,0.06635303342154268
595,MI,ROSCOMMON,94,957,1051,0.08943862987630828
596,CA,VENTURA,3660,21599,25259,0.14489884793538937
597,GA,DAWSON,40,69,109,0.3669724770642202
598,NH,GRAFTON,31,2173,2204,0.014065335753176044
599,AR,CONWAY,123,1235,1358,0.09057437407952872
600,CA,YUBA,339,3385,3724,0.091031149301826
601,FL,FLAGLER,344,4061,4405,0.07809307604994324
602,NM,TAOS,120,196,316,0.379746835443038
603,MN,CHISAGO,322,136,458,0.7030567685589519
604,OH,LUCAS,2738,20780,23518,0.11642146441023897
605,KS,RENO,480,4401,4881,0.09834050399508297
606,KY,LAUREL,384,6193,6577,0.05838528204348487
607,OK,TULSA,5269,32385,37654,0.13993201253518883
608,NC,WAYNE,542,6322,6864,0.07896270396270397
609,TN,TIPTON,151,2739,2890,0.05224913494809689
610,TX,DENTON,0,3,3,0.0
611,SC,NA,767,6051,6818,0.11249633323555294
612,FL,COLUMBIA,344,5746,6090,0.05648604269293925
613,NY,MADISON,33,245,278,0.11870503597122302
614,OK,BRYAN,359,3932,4291,0.08366348170589606
615,FL,MIAMI-DADE,10270,192960,203230,0.05053387787236136
616,CA,YOLO,677,10322,10999,0.061551050095463224
617,OK,OSAGE,298,2695,2993,0.09956565319077848
618,AR,COLUMBIA,96,835,931,0.10311493018259936
619,AK,KENAI PENINSULA,103,352,455,0.22637362637362637
620,CO,GARFIELD,273,2485,2758,0.09898477157360407
621,KY,BOYD,115,3349,3464,0.033198614318706694
622,GA,HART,4,21,25,0.16
623,CO,MONTEZUMA,164,399,563,0.2912966252220249
624,VA,TAZEWELL,180,2157,2337,0.07702182284980745
625,MO,BUCHANAN,0,1,1,0.0
626,CA,SHASTA,629,8383,9012,0.06979582778517532
627,VA,MONTGOMERY,188,6595,6783,0.027716349697773847
628,KY,MARSHALL,94,1780,1874,0.05016008537886873
629,WV,KANAWHA,6,13,19,0.3157894736842105
630,TN,NA,1376,20560,21936,0.06272793581327499
631,UT,SEVIER,7,2232,2239,0.0031263957123715946
632,IL,LOGAN,167,3318,3485,0.04791965566714491
633,FL,BREVARD,1794,11516,13310,0.13478587528174304
634,TN,BEDFORD,110,2208,2318,0.04745470232959448
635,NC,CASWELL,105,1360,1465,0.07167235494880546
636,IN,HOWARD,170,286,456,0.37280701754385964
637,ID,KOOTENAI,1028,205,1233,0.8337388483373885
638,TN,DICKSON,114,2097,2211,0.051560379918588875
639,GA,COLQUITT,29,43,72,0.4027777777777778
640,SC,MARLBORO,231,2348,2579,0.0895696006203955
641,MI,OAKLAND,2837,13021,15858,0.17890023962668686
642,TN,HARDIN,61,1495,1556,0.03920308483290488
643,MD,HOWARD,196,922,1118,0.17531305903398928
644,OK,WASHINGTON,384,3095,3479,0.11037654498419086
645,GA,RICHMOND,132,269,401,0.32917705735660846
646,CA,NEVADA,201,2831,3032,0.06629287598944592
647,TN,SCOTT,60,831,891,0.06734006734006734
648,SC,BARNWELL,109,1341,1450,0.07517241379310345
649,MN,NOBLES,215,411,626,0.34345047923322686
650,MN,WRIGHT,680,368,1048,0.648854961832061
651,NM,SAN JUAN,1710,2941,4651,0.367662868200387
652,GA,GWINNETT,837,965,1802,0.46448390677025525
653,FL,PASCO,2252,21357,23609,0.09538735228090982
654,IL,WHITESIDE,227,4157,4384,0.051779197080291973
655,PA,BRADFORD,247,1755,2002,0.12337662337662338
656,MI,DELTA,157,2215,2372,0.06618887015177066
657,FL,INDIAN RIVER,590,6385,6975,0.08458781362007169
658,NY,CAYUGA,19,117,136,0.13970588235294118
659,AR,BENTON,779,14693,15472,0.050349017580144775
660,MN,MCLEOD,230,61,291,0.7903780068728522
661,NY,WESTCHESTER,4113,5827,9940,0.41378269617706237
662,NY,RICHMOND,6687,1564,8251,0.8104472185189674
663,MO,JASPER,0,1,1,0.0
664,TX,BRAZOS,1,1,2,0.5
665,KS,BARTON,130,1857,1987,0.06542526421741318
666,MI,CHIPPEWA,115,1609,1724,0.06670533642691415
667,KY,WAYNE,53,1331,1384,0.03829479768786127
668,WI,MANITOWOC,394,4502,4896,0.08047385620915033
669,MN,ISANTI,262,87,349,0.7507163323782235
670,AR,ST. FRANCIS,188,1500,1688,0.11137440758293839
671,TN,SEVIER,252,4148,4400,0.057272727272727274
672,OK,JACKSON,217,2068,2285,0.0949671772428884
673,KY,PULASKI,166,4098,4264,0.038930581613508444
674,IL,KANE,4055,21262,25317,0.16016905636528814
675,SC,CLARENDON,258,2047,2305,0.11193058568329718
676,OH,GREENE,792,7636,8428,0.09397247271001424
677,CA,SAN FRANCISCO,1723,24310,26033,0.06618522644336035
678,CO,DELTA,181,1602,1783,0.10151430173864273
679,IA,MAHASKA,63,784,847,0.0743801652892562
680,KY,FAYETTE,1258,12852,14110,0.0891566265060241
681,NH,SULLIVAN,24,913,937,0.025613660618996798
682,TN,OVERTON,52,1183,1235,0.042105263157894736
683,MN,LYON,111,81,192,0.578125
684,IL,EFFINGHAM,95,404,499,0.1903807615230461
685,OH,AUGLAIZE,309,3391,3700,0.08351351351351351
686,PA,CRAWFORD,434,2492,2926,0.14832535885167464
687,MI,CLARE,100,1228,1328,0.07530120481927711
688,OH,MIAMI,592,2651,3243,0.18254702436016035
689,IL,NA,2216,18864,21080,0.10512333965844402
690,NM,SANDOVAL,928,2026,2954,0.3141503046716317
691,GA,BUTTS,35,23,58,0.603448275862069
692,TN,BLOUNT,313,4934,5247,0.05965313512483324
693,OK,PONTOTOC,323,3728,4051,0.07973339916070106
694,GA,WORTH,55,79,134,0.41044776119402987
695,WI,SAUK,262,3331,3593,0.0729195658224325
696,SC,NEWBERRY,177,2780,2957,0.05985796415285763
697,NY,KINGS,35402,6920,42322,0.8364916591843485
698,KY,TAYLOR,79,2681,2760,0.0286231884057971
699,AR,INDEPENDENCE,246,1617,1863,0.1320450885668277
700,MI,BRANCH,204,3672,3876,0.05263157894736842
701,ID,NEZ PERCE,75,2158,2233,0.03358710255261979
702,GA,SUMTER,28,20,48,0.5833333333333334
703,MO,JACKSON,1,1,2,0.5
704,NE,NA,5,27,32,0.15625
705,ME,KNOX,32,970,1002,0.031936127744510975
706,MT,MISSOULA,291,2336,2627,0.11077274457556148
707,ND,WILLIAMS,58,978,1036,0.055984555984555984
708,VA,PRINCE EDWARD,102,1159,1261,0.08088818398096749
709,AL,TALLAPOOSA,157,1292,1449,0.10835058661145618
710,CA,COLUSA,90,1634,1724,0.052204176334106726
711,KY,LOGAN,82,1347,1429,0.05738278516445067
712,KY,BOYLE,130,2362,2492,0.0521669341894061
713,NC,STANLY,259,3071,3330,0.07777777777777778
714,NC,ALEXANDER,187,1867,2054,0.09104186952288218
715,GA,WAYNE,70,88,158,0.4430379746835443
716,NY,SARATOGA,149,286,435,0.3425287356321839
717,VA,ALEXANDRIA CITY,560,9476,10036,0.05579912315663611
718,ID,BLAINE,179,1697,1876,0.09541577825159915
719,MI,MECOSTA,83,1678,1761,0.04713231118682567
720,IA,MARSHALL,78,1546,1624,0.0480295566502463
721,PA,LANCASTER,3425,11608,15033,0.2278321027073771
722,MN,ITASCA,319,463,782,0.4079283887468031
723,NY,CORTLAND,3,34,37,0.08108108108108109
724,AR,GREENE,339,3239,3578,0.09474566797093348
725,ME,FRANKLIN,26,1092,1118,0.023255813953488372
726,OR,UMATILLA,310,5921,6231,0.04975124378109453
727,OH,CUYAHOGA,7176,52022,59198,0.12122031149701003
728,OK,MAYES,296,2579,2875,0.10295652173913043
729,NM,LEA,382,1002,1384,0.27601156069364163
730,OH,MARION,411,3299,3710,0.11078167115902965
731,SC,SUMTER,513,6701,7214,0.07111172719711671
732,AL,WALKER,233,2272,2505,0.09301397205588822
733,NM,BERNALILLO,3678,5818,9496,0.38732097725358045
734,TN,COFFEE,102,2304,2406,0.04239401496259352
735,MN,POLK,151,117,268,0.5634328358208955
736,GA,WHITFIELD,15,42,57,0.2631578947368421
737,OR,DESCHUTES,333,8852,9185,0.03625476320087098
738,NC,WILKES,170,3185,3355,0.05067064083457526
739,OH,PERRY,193,1501,1694,0.11393152302243212
740,MS,JONES,153,961,1114,0.13734290843806105
741,NV,NYE,153,656,809,0.18912237330037082
742,SC,SALUDA,63,938,1001,0.06293706293706294
743,ID,BONNER,97,35,132,0.7348484848484849
744,NY,CLINTON,23,131,154,0.14935064935064934
745,KS,SEWARD,393,2948,3341,0.11762945225980245
746,MS,NESHOBA,117,332,449,0.26057906458797325
747,AL,MARSHALL,149,3164,3313,0.044974343495321464
748,ND,MORTON,64,1190,1254,0.051036682615629984
749,OH,SCIOTO,504,1467,1971,0.2557077625570776
750,OH,PORTAGE,805,7973,8778,0.09170653907496013
751,ME,LINCOLN,22,848,870,0.02528735632183908
752,AL,RUSSELL,54,1128,1182,0.04568527918781726
753,IN,DEKALB,18,102,120,0.15
754,NH,NA,13,429,442,0.029411764705882353
755,OH,HENRY,188,1921,2109,0.08914177335229967
756,IA,WOODBURY,591,7136,7727,0.0764850524136146
757,MI,GENESEE,3213,12782,15995,0.20087527352297593
758,KY,BARREN,150,2866,3016,0.04973474801061008
759,PA,PHILADELPHIA,11644,840,12484,0.9327138737584107
760,NY,TIOGA,16,88,104,0.15384615384615385
761,CT,NEW LONDON,249,1059,1308,0.19036697247706422
762,IN,VIGO,146,128,274,0.5328467153284672
763,GA,TOOMBS,40,29,69,0.5797101449275363
764,SC,KERSHAW,316,4231,4547,0.06949637123378051
765,SC,HORRY,2254,25622,27876,0.08085808580858085
766,CA,TUOLUMNE,197,2255,2452,0.08034257748776509
767,OH,LAWRENCE,448,2741,3189,0.14048291000313579
768,VA,ROCKINGHAM,410,4150,4560,0.08991228070175439
769,MI,MUSKEGON,145,1981,2126,0.06820319849482596
770,GA,CLAYTON,63,63,126,0.5
771,WA,CLALLAM,70,1353,1423,0.049191848208011243
772,OH,BELMONT,328,4211,4539,0.07226261291033267
773,AZ,COCHISE,758,5731,6489,0.11681306826937896
774,FL,BAY,683,7798,8481,0.08053295601933734
775,CO,FREMONT,186,1661,1847,0.10070384407146725
776,NY,ORLEANS,39,233,272,0.14338235294117646
777,SC,CHEROKEE,441,3043,3484,0.12657864523536166
778,UT,SUMMIT,40,5175,5215,0.007670182166826462
779,WI,DODGE,640,6999,7639,0.08378059955491557
780,IN,HARRISON,50,257,307,0.16286644951140064
781,KS,RILEY,175,3646,3821,0.04579952891913112
782,SC,LANCASTER,403,5557,5960,0.06761744966442954
783,AR,HOT SPRING,231,2509,2740,0.0843065693430657
784,CO,ADAMS,3243,15184,18427,0.1759917512346014
785,AR,GARLAND,407,5700,6107,0.06664483379728181
786,IL,MCDONOUGH,166,1691,1857,0.08939149165320409
787,KY,SCOTT,82,3077,3159,0.025957581513137068
788,KS,DOUGLAS,486,6167,6653,0.07304975199158274
789,TN,CHEATHAM,84,1752,1836,0.0457516339869281
790,IA,CERRO GORDO,46,1092,1138,0.040421792618629174
791,CA,BUTTE,556,4471,5027,0.11060274517604933
792,IN,MARSHALL,24,81,105,0.22857142857142856
793,GA,BARTOW,9,23,32,0.28125
794,FL,SUMTER,442,4097,4539,0.09737827715355805
795,FL,NASSAU,244,3596,3840,0.06354166666666666
796,WI,OUTAGAMIE,755,12085,12840,0.0588006230529595
797,TN,CARTER,215,2440,2655,0.08097928436911488
798,MI,OCEANA,157,1492,1649,0.09520921770770163
799,TN,MCNAIRY,53,1064,1117,0.047448522829006266
800,NC,STOKES,173,2806,2979,0.05807317891910037
801,TN,MONROE,149,1914,2063,0.07222491517207949
802,MT,CASCADE,380,3763,4143,0.09172097513878832
803,VA,HARRISONBURG CITY,188,4213,4401,0.04271756418995683
804,AL,MADISON,448,9043,9491,0.04720261300179117
805,AL,DALLAS,201,1116,1317,0.15261958997722094
806,IA,WARREN,49,1194,1243,0.039420756234915526
807,MN,PINE,195,202,397,0.491183879093199
808,GA,CRISP,14,14,28,0.5
809,UT,UTAH,159,93952,94111,0.001689494320536388
810,ME,AROOSTOOK,77,1341,1418,0.054301833568406205
811,SC,UNION,287,1363,1650,0.17393939393939395
812,MI,MASON,139,1137,1276,0.10893416927899686
813,NC,ONSLOW,525,14291,14816,0.035434665226781854
814,NC,CALDWELL,202,4725,4927,0.04099857925715446
815,WI,PORTAGE,288,3171,3459,0.08326105810928014
816,AL,WINSTON,64,826,890,0.07191011235955057
817,AZ,MOHAVE,2125,12768,14893,0.14268448264285236
818,PA,LUZERNE,973,7984,8957,0.10863012169253099
819,IL,MACOUPIN,83,414,497,0.16700201207243462
820,IN,MADISON,151,471,622,0.2427652733118971
821,NY,FULTON,51,141,192,0.265625
822,GA,MURRAY,46,135,181,0.2541436464088398
823,WA,NA,582,9814,10396,0.055983070411696804
824,IL,ADAMS,369,3355,3724,0.09908700322234157
825,AZ,SANTA CRUZ,572,5360,5932,0.0964261631827377
826,NC,CHEROKEE,104,1331,1435,0.07247386759581882
827,CA,CALAVERAS,23,331,354,0.06497175141242938
828,AR,OUACHITA,89,1356,1445,0.061591695501730104
829,NM,RIO ARRIBA,252,330,582,0.4329896907216495
830,IN,CLINTON,35,136,171,0.2046783625730994
831,WA,LEWIS,401,4900,5301,0.07564610450858329
832,IN,HENDRICKS,215,921,1136,0.1892605633802817
833,WI,KEWAUNEE,125,1331,1456,0.08585164835164835
834,OH,CRAWFORD,325,3288,3613,0.08995294768890119
835,MI,CHEBOYGAN,42,764,806,0.052109181141439205
836,VA,MANASSAS CITY,176,2391,2567,0.06856252434748734
837,AK,MATANUSKA-SUSITNA,187,386,573,0.3263525305410122
838,DE,KENT,12,17,29,0.41379310344827586
839,WA,WALLA WALLA,278,5213,5491,0.05062830085594609
840,MI,KALAMAZOO,789,9243,10032,0.07864832535885168
841,NC,LEE,287,4307,4594,0.06247279059643013
842,MS,RANKIN,153,912,1065,0.14366197183098592
843,PA,CLARION,201,771,972,0.20679012345679013
844,AL,COVINGTON,78,1215,1293,0.060324825986078884
845,IN,ST. JOSEPH,176,706,882,0.19954648526077098
846,KS,HARVEY,232,2930,3162,0.07337128399746995
847,AR,PULASKI,3023,23557,26580,0.113732129420617
848,CA,KINGS,841,11061,11902,0.070660393211225
849,FL,CITRUS,459,5823,6282,0.07306590257879657
850,MI,WAYNE,5286,40454,45740,0.11556624398775689
851,IN,WASHINGTON,45,201,246,0.18292682926829268
852,TX,POTTER,0,1,1,0.0
853,KS,NA,3939,42135,46074,0.08549290272170855
854,CA,ALAMEDA,3887,46984,50871,0.07640895598671149
855,AR,LOGAN,82,1139,1221,0.06715806715806716
856,OH,WILLIAMS,176,2431,2607,0.06751054852320675
857,AL,DEKALB,103,2157,2260,0.045575221238938056
858,GA,COBB,209,137,346,0.6040462427745664
859,MI,BARRY,210,3315,3525,0.059574468085106386
860,NH,MERRIMACK,127,4420,4547,0.02793050362876622
861,NC,SCOTLAND,281,3012,3293,0.08533252353477072
862,KY,ROWAN,50,1881,1931,0.02589331952356292
863,OR,CLACKAMAS,883,10707,11590,0.07618636755823986
864,FL,OSCEOLA,1260,17227,18487,0.0681560015145778
865,IN,STARKE,33,382,415,0.07951807228915662
866,IA,WEBSTER,59,1149,1208,0.048841059602649006
867,FL,ORANGE,2294,29013,31307,0.07327434758999585
868,PA,VENANGO,255,954,1209,0.2109181141439206
869,IN,SULLIVAN,15,20,35,0.42857142857142855
870,GA,TIFT,158,497,655,0.24122137404580152
871,NY,GENESEE,19,178,197,0.09644670050761421
872,MI,NEWAYGO,266,2508,2774,0.0958904109589041
873,OH,ATHENS,208,3636,3844,0.054110301768990635
874,OH,DARKE,301,2957,3258,0.09238796807857581
875,AR,JOHNSON,115,1798,1913,0.06011500261369577
876,OK,LE FLORE,233,4010,4243,0.05491397596040537
877,MI,OTTAWA,995,20808,21803,0.04563592166215658
878,VA,BUCHANAN,111,1003,1114,0.09964093357271095
879,IN,JASPER,44,438,482,0.0912863070539419
880,TN,WILLIAMSON,249,9008,9257,0.02689856324943286
881,VA,WYTHE,169,1805,1974,0.085612968591692
882,WI,VERNON,77,757,834,0.09232613908872901
883,ID,ELMORE,137,1937,2074,0.06605593056894889
884,MI,GRAND TRAVERSE,283,4165,4448,0.06362410071942447
885,WI,SHAWANO,204,3150,3354,0.06082289803220036
886,NH,CHESHIRE,35,1931,1966,0.01780264496439471
887,MI,VAN BUREN,234,3396,3630,0.06446280991735537
888,NC,CLEVELAND,636,5915,6551,0.09708441459319188
889,AK,FAIRBANKS NORTH STAR,160,836,996,0.1606425702811245
890,MN,RAMSEY,3966,1587,5553,0.7142085359265262
891,FL,MANATEE,1181,18684,19865,0.05945129624968538
892,OH,MADISON,164,2345,2509,0.06536468712634516
893,CA,TEHAMA,201,2881,3082,0.06521739130434782
894,WI,GRANT,244,1900,2144,0.11380597014925373
895,TN,WEAKLEY,69,1763,1832,0.03766375545851528
896,PA,CHESTER,1497,17551,19048,0.07859092818143637
897,ID,CANYON,1148,19283,20431,0.05618912436983016
898,VA,STAUNTON CITY,82,1363,1445,0.05674740484429066
899,NC,HERTFORD,146,902,1048,0.13931297709923665
900,WI,RACINE,1296,16946,18242,0.07104484157438877
901,PA,PERRY,115,758,873,0.13172966781214204
902,IN,FAYETTE,47,315,362,0.1298342541436464
903,IL,TAZEWELL,497,5586,6083,0.08170310701956271
904,DE,NEW CASTLE,22,127,149,0.1476510067114094
905,WI,EAU CLAIRE,347,8297,8644,0.04014345210550671
906,WI,WAUSHARA,109,1058,1167,0.0934018851756641
907,NC,CUMBERLAND,1416,19149,20565,0.06885485047410649
908,ME,OXFORD,116,2616,2732,0.0424597364568082
909,OK,CLEVELAND,1602,18366,19968,0.08022836538461539
910,OK,CHEROKEE,355,3932,4287,0.0828084907860975
911,MD,WORCESTER,204,4789,4993,0.040857200080112156
912,TN,MORGAN,30,670,700,0.04285714285714286
913,GA,THOMAS,138,450,588,0.23469387755102042
914,IA,BUCHANAN,22,416,438,0.0502283105022831
915,IN,GREENE,31,110,141,0.2198581560283688
916,KY,JESSAMINE,219,3633,3852,0.05685358255451713
917,KS,SHAWNEE,932,8582,9514,0.09796089972671852
918,KY,HARDIN,463,7129,7592,0.06098524762908324
919,IL,MCHENRY,1876,13294,15170,0.12366512854317732
920,OR,POLK,198,3239,3437,0.05760837940064009
921,KS,SEDGWICK,3329,38531,41860,0.07952699474438604
922,AL,MORGAN,197,3915,4112,0.04790856031128405
923,NY,NIAGARA,174,433,607,0.28665568369028005
924,NY,PUTNAM,239,1943,2182,0.10953253895508708
925,TN,LAUDERDALE,80,1448,1528,0.05235602094240838
926,MN,STEELE,131,252,383,0.34203655352480417
927,CA,AMADOR,137,896,1033,0.13262342691190707
928,MN,BENTON,276,270,546,0.5054945054945055
929,CO,BROOMFIELD,216,2482,2698,0.08005930318754632
930,NY,ONTARIO,39,166,205,0.1902439024390244
931,CO,MONTROSE,172,1758,1930,0.08911917098445596
932,MI,WASHTENAW,1575,14364,15939,0.09881422924901186
933,ME,ANDROSCOGGIN,255,5974,6229,0.040937550168566386
934,CA,SAN LUIS OBISPO,851,17369,18220,0.04670691547749726
935,MI,EATON,746,5406,6152,0.12126137841352405
936,ME,SOMERSET,77,1604,1681,0.04580606781677573
937,CT,FAIRFIELD,3169,7942,11111,0.28521285212852127
938,OK,GRADY,295,4138,4433,0.06654635686893752
939,WI,COLUMBIA,290,3184,3474,0.08347725964306275
940,MN,CARLTON,175,119,294,0.5952380952380952
941,PA,BUTLER,460,3771,4231,0.10872134247222878
942,KY,FRANKLIN,181,3337,3518,0.05144968732234224
943,WA,THURSTON,734,10426,11160,0.06577060931899642
944,OK,GARFIELD,314,3774,4088,0.07681017612524461
945,MT,GALLATIN,438,10162,10600,0.041320754716981135
946,OH,SANDUSKY,371,3390,3761,0.09864397766551448
947,CA,NAPA,373,6844,7217,0.05168352501039213
948,LA,CADDO,166,387,553,0.30018083182640143
949,KY,MCCRACKEN,145,3029,3174,0.045683679899180846
950,GA,STEPHENS,14,136,150,0.09333333333333334
951,IA,BREMER,14,638,652,0.02147239263803681
952,GA,MCDUFFIE,12,12,24,0.5
953,ND,WARD,83,2043,2126,0.039040451552210725
954,VA,PRINCE WILLIAM,1673,25301,26974,0.06202268851486617
955,MD,SOMERSET,136,775,911,0.14928649835345773
956,MN,FREEBORN,173,189,362,0.47790055248618785
957,IN,HAMILTON,350,920,1270,0.2755905511811024
958,NV,NA,321,3159,3480,0.09224137931034483
959,TX,EL PASO,14,152,166,0.08433734939759036
960,IN,DELAWARE,231,608,839,0.27532777115613827
961,GA,COLUMBIA,86,153,239,0.3598326359832636
962,IL,FRANKLIN,206,190,396,0.5202020202020202
963,VA,LOUISA,110,1431,1541,0.07138221933809215
964,OH,HOLMES,264,1869,2133,0.12376933895921238
965,MT,RAVALLI,138,2304,2442,0.056511056511056514
966,OH,STARK,2089,9057,11146,0.1874214965009869
967,VA,NEW KENT,37,770,807,0.04584882280049566
968,VA,FLUVANNA,83,1029,1112,0.07464028776978417
969,CA,LOS ANGELES,92865,22342,115207,0.8060708116694298
970,MI,ALPENA,54,815,869,0.06214039125431531
971,MN,KANDIYOHI,266,297,563,0.4724689165186501
972,PR,NA,3328,2999,6327,0.5259996838944208
973,PA,LYCOMING,324,2383,2707,0.11968969338751385
974,OR,CROOK,80,970,1050,0.0761904761904762
975,AL,ST. CLAIR,233,2689,2922,0.07973990417522245
976,GA,GLYNN,6,25,31,0.1935483870967742
977,NA,NA,96,254,350,0.2742857142857143
978,CA,SONOMA,1600,19599,21199,0.07547525826689938
979,NC,CATAWBA,855,11148,12003,0.071232191952012
980,SC,DARLINGTON,493,5383,5876,0.0839006126616746
981,CT,WINDHAM,168,539,707,0.2376237623762376
982,FL,ESCAMBIA,1636,12800,14436,0.11332779163203104
983,MN,CLAY,315,383,698,0.4512893982808023
984,NM,NA,1195,1851,3046,0.3923177938279711
985,WI,MARINETTE,244,2522,2766,0.08821402747650037
986,NY,ST. LAWRENCE,25,184,209,0.11961722488038277
987,MN,CROW WING,367,382,749,0.48998664886515353
988,GA,FAYETTE,10,9,19,0.5263157894736842
989,VT,NA,127,4154,4281,0.029665965895818734
990,WA,STEVENS,165,2184,2349,0.070242656449553
991,VA,FREDERICK,252,4349,4601,0.054770702021299716
992,TN,MACON,102,1349,1451,0.07029634734665748
993,MI,GRATIOT,185,2141,2326,0.07953568357695615
994,ID,ADA,2076,51025,53101,0.039095308939567995
995,SC,LEXINGTON,879,18420,19299,0.04554640136794653
996,IN,BOONE,69,203,272,0.2536764705882353
997,IN,DECATUR,59,190,249,0.23694779116465864
998,IL,MORGAN,144,393,537,0.2681564245810056
999,TN,GIBSON,113,2520,2633,0.042916824914546146
1000,NC,GREENE,104,1332,1436,0.07242339832869081
1001,OK,CUSTER,182,2335,2517,0.0723083035359555
1002,NJ,CUMBERLAND,2951,10238,13189,0.22374706194556068
1003,FL,SARASOTA,1011,11204,12215,0.08276708964388048
1004,NC,DARE,71,1620,1691,0.041986989946777055
1005,WI,POLK,183,2212,2395,0.07640918580375783
1006,IN,LAGRANGE,34,59,93,0.3655913978494624
1007,MI,BAY,692,4657,5349,0.12936997569639186
1008,SC,COLLETON,235,1918,2153,0.10915002322340919
1009,VA,HAMPTON CITY,457,5367,5824,0.07846840659340659
1010,PA,DAUPHIN,1307,3831,5138,0.2543791358505255
1011,MS,MADISON,171,1116,1287,0.13286713286713286
1012,GA,DOUGLAS,138,309,447,0.3087248322147651
1013,CA,IMPERIAL,2094,15122,17216,0.12163104089219332
1014,CA,LASSEN,89,3117,3206,0.02776044915782907
1015,NC,LINCOLN,431,5929,6360,0.06776729559748428
1016,IL,LEE,116,787,903,0.12846068660022147
1017,IL,ROCK ISLAND,339,2565,2904,0.11673553719008264
1018,NC,ANSON,157,1943,2100,0.07476190476190477
1019,WI,OCONTO,255,3534,3789,0.06730007917656373
1020,MO,GREENE,3,7,10,0.3
1021,IL,SALINE,71,371,442,0.16063348416289594
1022,IL,PEORIA,1330,3494,4824,0.27570480928689883
1023,CT,MIDDLESEX,493,742,1235,0.3991902834008097
1024,GA,COFFEE,146,179,325,0.4492307692307692
1025,MA,WORCESTER,1930,11280,13210,0.1461014383043149
1026,IL,OGLE,297,4582,4879,0.06087312973970076
1027,OK,OKLAHOMA,5032,28283,33315,0.1510430736905298
1028,FL,VOLUSIA,1850,16132,17982,0.102880658436214
1029,IN,SPENCER,11,123,134,0.08208955223880597
1030,VA,ISLE OF WIGHT,154,2167,2321,0.06635071090047394
1031,FL,TAYLOR,68,1104,1172,0.05802047781569966
1032,MN,RICE,335,637,972,0.3446502057613169
1033,IN,WELLS,53,118,171,0.30994152046783624
1034,KS,COWLEY,324,2442,2766,0.11713665943600868
1035,FL,POLK,4133,27693,31826,0.1298623766731603
1036,NM,CURRY,329,620,949,0.3466807165437302
1037,GA,UPSON,22,121,143,0.15384615384615385
1038,IN,TIPPECANOE,100,1097,1197,0.0835421888053467
1039,IN,PORTER,147,686,833,0.17647058823529413
1040,IL,BUREAU,78,315,393,0.1984732824427481
1041,MN,OTTER TAIL,297,154,451,0.6585365853658537
1042,GA,MUSCOGEE,114,47,161,0.7080745341614907
1043,VT,CHITTENDEN,149,6513,6662,0.02236565595917142
1044,FL,CLAY,690,8766,9456,0.07296954314720812
1045,VT,RUTLAND,82,1750,1832,0.04475982532751092
1046,FL,MARTIN,604,8466,9070,0.06659316427783903
1047,IN,WHITE,23,203,226,0.10176991150442478
1048,PA,WARREN,90,473,563,0.15985790408525755
1049,CO,ARAPAHOE,3932,17569,21501,0.18287521510627414
1050,OR,WASHINGTON,1293,18456,19749,0.06547166945161781
1051,MD,ST. MARY'S,109,884,993,0.10976837865055387
1052,MI,SAGINAW,982,8382,9364,0.10486971379752243
1053,IL,RANDOLPH,56,578,634,0.08832807570977919
1054,WI,WASHINGTON,481,4120,4601,0.10454249076287764
1055,IL,JEFFERSON,86,151,237,0.3628691983122363
1056,IL,JO DAVIESS,55,155,210,0.2619047619047619
1057,NC,HAYWOOD,134,2534,2668,0.05022488755622189
1058,KS,CRAWFORD,202,3329,3531,0.05720758991787029
1059,CA,SAN BERNARDINO,11138,136436,147574,0.07547399948500413
1060,FL,PUTNAM,527,4451,4978,0.10586580956207312
1061,OH,PIKE,184,1922,2106,0.08736942070275404
1062,MD,WICOMICO,137,1432,1569,0.08731676226896112
1063,IL,GRUNDY,127,431,558,0.22759856630824374
1064,TX,DALLAS,5,4,9,0.5555555555555556
1065,GA,HARALSON,1,4,5,0.2
1066,HI,HAWAII,2,0,2,1.0
1067,IL,SHELBY,77,1410,1487,0.05178211163416274
1068,NC,GRANVILLE,266,3538,3804,0.06992639327024185
1069,OK,PAYNE,308,6327,6635,0.04642049736247174
1070,NC,CURRITUCK,42,330,372,0.11290322580645161
1071,PA,NORTHAMPTON,936,12073,13009,0.07195018833115535
1072,KY,HENDERSON,99,2667,2766,0.03579175704989154
1073,GA,HABERSHAM,47,86,133,0.3533834586466165
1074,NC,RANDOLPH,544,11817,12361,0.04400938435401667
1075,NC,NASH,660,5510,6170,0.10696920583468396
1076,WA,ASOTIN,97,1375,1472,0.06589673913043478
1077,IN,JENNINGS,28,244,272,0.10294117647058823
1078,ME,HANCOCK,46,913,959,0.047966631908237745
1079,NC,CRAVEN,688,5331,6019,0.11430470177770394
1080,TX,BRAZORIA,0,1,1,0.0
1081,CA,SISKIYOU,133,1223,1356,0.09808259587020648
1082,AL,BLOUNT,93,1782,1875,0.0496
1083,NC,GUILFORD,1674,21910,23584,0.07098032564450475
1084,CT,LITCHFIELD,385,1400,1785,0.21568627450980393
1085,NH,CARROLL,31,1188,1219,0.02543068088597211
1086,GA,FRANKLIN,21,52,73,0.2876712328767123
1087,RI,NA,12,63,75,0.16
1088,WA,GRAYS HARBOR,234,4320,4554,0.05138339920948617
1089,MI,HOUGHTON,83,1927,2010,0.04129353233830846
1090,MD,WASHINGTON,139,2313,2452,0.0566884176182708
1091,OK,SEMINOLE,227,1891,2118,0.10717658168083097
1092,VA,WINCHESTER CITY,114,1549,1663,0.06855081178592905
1093,PA,GREENE,121,749,870,0.13908045977011493
1094,IL,WILL,4540,15466,20006,0.22693192042387283
1095,MD,MONTGOMERY,27,463,490,0.05510204081632653
1096,IA,NA,1671,26659,28330,0.05898340981291917
1097,VT,WINDSOR,51,1113,1164,0.04381443298969072
1098,WA,KITTITAS,117,3236,3353,0.03489412466447957
1099,KS,JOHNSON,2602,28049,30651,0.08489119441453787
1100,OR,MULTNOMAH,2667,23318,25985,0.10263613623244179
1101,KS,FINNEY,246,4348,4594,0.05354810622551154
1102,NY,COLUMBIA,172,549,721,0.23855755894590847
1103,VA,WASHINGTON,425,3303,3728,0.11400214592274678
1104,IN,CLARK,137,903,1040,0.13173076923076923
1105,GA,JONES,32,33,65,0.49230769230769234
1106,DE,SUSSEX,9,29,38,0.23684210526315788
1107,NC,RICHMOND,329,3543,3872,0.08496900826446281
1108,FL,LEVY,179,2184,2363,0.07575116377486246
1109,MA,ESSEX,2737,21588,24325,0.11251798561151079
1110,VA,LOUDOUN,1086,13477,14563,0.07457254686534368
1111,NY,GREENE,71,183,254,0.2795275590551181
1112,KS,FRANKLIN,135,1010,1145,0.11790393013100436
1113,MN,HENNEPIN,7837,3904,11741,0.6674899923345541
1114,GA,MADISON,33,57,90,0.36666666666666664
1115,VA,AUGUSTA,186,2799,2985,0.062311557788944726
1116,OR,MALHEUR,232,2473,2705,0.08576709796672828
1117,OK,KAY,272,3504,3776,0.07203389830508475
1118,OH,HANCOCK,483,4690,5173,0.09336941813261164
1119,NV,CHURCHILL,43,876,919,0.046789989118607184
1120,AL,COLBERT,117,1652,1769,0.06613906161673262
1121,AL,CHAMBERS,152,1027,1179,0.1289228159457167
1122,GA,MONROE,28,29,57,0.49122807017543857
1123,AR,SEBASTIAN,640,7809,8449,0.07574860930287608
1124,WI,BARRON,230,2942,3172,0.0725094577553594
1125,VA,PULASKI,129,1484,1613,0.07997520148791072
1126,OH,WAYNE,455,4036,4491,0.10131373858828768
1127,VA,VIRGINIA BEACH CITY,1728,20540,22268,0.07760014370396982
1128,OK,ADAIR,234,2114,2348,0.09965928449744463
1129,VA,WARREN,119,1698,1817,0.0654925701706109
1130,WI,IOWA,82,890,972,0.08436213991769548
1131,AL,ELMORE,194,2564,2758,0.07034082668600435
1132,GA,PICKENS,17,13,30,0.5666666666666667
1133,NY,OTSEGO,15,57,72,0.20833333333333334
1134,OK,NA,2898,28930,31828,0.09105190398391354
1135,CT,HARTFORD,2841,9979,12820,0.221606864274571
1136,MN,MOWER,215,342,557,0.3859964093357271
1137,MN,TODD,136,177,313,0.43450479233226835
1138,MD,ALLEGANY,332,5783,6115,0.05429272281275552
1139,CA,SUTTER,547,4231,4778,0.11448304730012558
1140,MI,IONIA,179,4396,4575,0.03912568306010929
1141,NC,FRANKLIN,99,1621,1720,0.05755813953488372
1142,LA,ORLEANS,451,558,1009,0.44697720515361744
1143,PA,MONTGOMERY,1792,8234,10026,0.17873528825054857
1144,SC,MARION,274,2186,2460,0.11138211382113822
1145,KY,JEFFERSON,938,3456,4394,0.21347291761492945
1146,IL,CLINTON,124,329,453,0.2737306843267108
1147,FL,DESOTO,215,2978,3193,0.06733479486376448
1148,CA,SANTA CRUZ,512,9562,10074,0.05082390311693468
1149,IN,WAYNE,69,1248,1317,0.05239179954441914
1150,OH,SUMMIT,4480,26125,30605,0.14638131024342427
1151,AK,JUNEAU,49,111,160,0.30625
1152,IL,MONROE,129,391,520,0.24807692307692308
1153,NY,JEFFERSON,6,41,47,0.1276595744680851
1154,MI,NA,1074,11488,12562,0.08549594013692087
1155,NC,HALIFAX,411,2327,2738,0.15010956902848796
1156,NJ,MIDDLESEX,9745,43178,52923,0.18413544205732857
1157,KY,PERRY,142,1691,1833,0.07746863066012002
1158,OH,PREBLE,288,1730,2018,0.14271555996035679
1159,MI,CLINTON,360,3168,3528,0.10204081632653061
1160,PA,HUNTINGDON,82,841,923,0.08884073672806067
1161,FL,BAKER,130,1717,1847,0.07038440714672442
1162,GA,WALKER,0,30,30,0.0
1163,MI,CALHOUN,480,6778,7258,0.06613392119041059
1164,KS,FORD,381,4001,4382,0.08694659972615244
1165,FL,HERNANDO,610,11168,11778,0.051791475632535236
1166,TN,RHEA,83,1545,1628,0.05098280098280098
1167,AR,JEFFERSON,606,4899,5505,0.11008174386920981
1168,NY,CHAUTAUQUA,13,62,75,0.17333333333333334
1169,CA,SAN JOAQUIN,3534,19366,22900,0.1543231441048035
1170,IN,NA,696,2002,2698,0.25796886582653816
1171,NC,NA,1581,14512,16093,0.09824147144721307
1172,SD,NA,4,20,24,0.16666666666666666
1173,KY,NELSON,205,3764,3969,0.05165028974552784
1174,VA,CHESAPEAKE CITY,1039,11944,12983,0.08002772856812755
1175,NC,MOORE,522,4211,4733,0.11028945700401437
1176,NC,PASQUOTANK,141,1564,1705,0.08269794721407625
1177,CO,PUEBLO,1443,7098,8541,0.1689497716894977
1178,KS,GEARY,125,1426,1551,0.08059316569954868
1179,IA,BOONE,30,241,271,0.11070110701107011
1180,PA,CARBON,196,1333,1529,0.12818835840418574
1181,SC,ORANGEBURG,528,5454,5982,0.08826479438314945
1182,ID,NA,1088,13317,14405,0.07552933009371746
1183,MT,YELLOWSTONE,1335,16651,17986,0.07422439675303014
1184,IL,COOK,35473,108799,144272,0.2458758456249307
1185,PA,CAMBRIA,746,3333,4079,0.1828879627359647
1186,SC,DORCHESTER,465,10127,10592,0.04390105740181269
1187,VT,ORLEANS,23,1097,1120,0.020535714285714286
1188,VA,BOTETOURT,66,1264,1330,0.04962406015037594
1189,IA,JONES,36,577,613,0.05872756933115824
1190,AL,GENEVA,52,603,655,0.07938931297709924
1191,OH,COSHOCTON,209,2150,2359,0.08859686307757525
1192,KY,MERCER,61,1330,1391,0.04385334291876348
1193,AL,ESCAMBIA,77,1009,1086,0.070902394106814
1194,MD,NA,241,2925,3166,0.07612128869235628
1195,IL,LAKE,5010,31641,36651,0.13669476958336743
1196,GA,BALDWIN,61,46,107,0.5700934579439252
1197,NY,DELAWARE,7,22,29,0.2413793103448276
1198,WA,KING,6572,106445,113017,0.058150543723510625
1199,FL,WASHINGTON,76,1232,1308,0.0581039755351682
1200,MT,LEWIS AND CLARK,303,3525,3828,0.07915360501567398
1201,FL,PINELLAS,4180,37405,41585,0.10051701334615847
1202,TN,HICKMAN,51,939,990,0.051515151515151514
1203,WI,PIERCE,112,2747,2859,0.039174536551241694
1204,CO,SUMMIT,85,1886,1971,0.043125317097919835
1205,MN,LE SUEUR,150,119,269,0.5576208178438662
1206,NY,ULSTER,30,53,83,0.3614457831325301
1207,WI,SHEBOYGAN,624,5397,6021,0.10363726955655207
1208,AL,MONTGOMERY,751,7561,8312,0.09035129932627527
1209,AL,COFFEE,91,1499,1590,0.057232704402515724
1210,CO,ELBERT,102,198,300,0.34
1211,MN,SCOTT,866,443,1309,0.6615737203972498
1212,PA,FRANKLIN,344,3193,3537,0.09725756290641786
1213,PA,CLEARFIELD,149,2000,2149,0.0693345742205677
1214,WI,WINNEBAGO,836,8273,9109,0.0917773630475354
1215,MS,WASHINGTON,151,857,1008,0.1498015873015873
1216,KS,SALINE,337,4949,5286,0.06375331063185774
1217,VA,JAMES CITY,169,2009,2178,0.0775941230486685
1218,AZ,APACHE,1225,2001,3226,0.379727216367018
1219,NY,WYOMING,7,60,67,0.1044776119402985
1220,MO,JEFFERSON,0,1,1,0.0
1221,MN,DODGE,59,129,188,0.31382978723404253
1222,VA,STAFFORD,376,4242,4618,0.08142052836725855
1223,NY,WAYNE,8,20,28,0.2857142857142857
1224,NJ,HUNTERDON,858,6237,7095,0.12093023255813953
1225,KY,HOPKINS,378,3579,3957,0.09552691432903715
1226,MI,OGEMAW,87,711,798,0.10902255639097744
1227,CA,LAKE,193,2856,3049,0.06329944244014431
1228,PA,JUNIATA,29,284,313,0.0926517571884984
1229,NM,DOÑA ANA,1349,2844,4193,0.32172668733603627
1230,GA,FLOYD,4,4,8,0.5
1231,WI,JUNEAU,158,1150,1308,0.12079510703363915
1232,KY,MONTGOMERY,131,2417,2548,0.05141287284144427
1233,NJ,WARREN,1003,5844,6847,0.1464875127793194
1234,MS,HARRISON,110,1255,1365,0.08058608058608059
1235,MD,BALTIMORE,254,1210,1464,0.17349726775956284
1236,AK,NA,296,2543,2839,0.10426206410707996
1237,KY,ANDERSON,130,2370,2500,0.052
1238,OR,JOSEPHINE,313,2465,2778,0.11267098632109432
1239,TN,WHITE,104,1470,1574,0.06607369758576874
1240,OR,CLATSOP,46,860,906,0.05077262693156733
1241,AL,CLARKE,81,808,889,0.09111361079865017
1242,OR,JEFFERSON,174,1611,1785,0.09747899159663866
1243,UT,SALT LAKE,4483,147846,152329,0.029429721195570115
1244,NH,HILLSBOROUGH,773,17525,18298,0.04224505410427369
1245,NC,VANCE,223,3031,3254,0.06853103872157344
1246,OR,YAMHILL,120,3429,3549,0.0338123415046492
1247,OH,WASHINGTON,203,1292,1495,0.13578595317725753
1248,MN,MEEKER,132,41,173,0.7630057803468208
1249,FL,HILLSBOROUGH,2424,35202,37626,0.06442353691596236
1250,CA,DEL NORTE,20,855,875,0.022857142857142857
1251,IA,BLACK HAWK,299,4712,5011,0.05966872879664738
1252,OH,LORAIN,1542,4265,5807,0.26554158773893577
1253,MN,STEARNS,971,844,1815,0.5349862258953169
1254,CO,CHAFFEE,35,177,212,0.1650943396226415
1255,MD,GARRETT,23,324,347,0.06628242074927954
1256,NE,HALL,0,4,4,0.0
1257,CA,SAN DIEGO,15585,267841,283426,0.054987898075688185
1258,NC,PERSON,118,2386,2504,0.04712460063897764
1259,UT,SANPETE,10,3835,3845,0.002600780234070221
1260,KY,GRAYSON,155,1805,1960,0.07908163265306123
1261,VA,PITTSYLVANIA,239,2650,2889,0.0827275874004846
1262,CO,JEFFERSON,2613,16125,18738,0.13944924751841178
1263,NM,OTERO,285,920,1205,0.23651452282157676
1264,WI,DANE,1490,24949,26439,0.05635614054994516
1265,CO,EAGLE,144,3884,4028,0.03574975173783516
1266,KY,LINCOLN,60,1308,1368,0.043859649122807015
1267,AR,FAULKNER,549,6878,7427,0.07391948296755083
1268,WI,LINCOLN,136,1857,1993,0.0682388359257401
1269,AL,BIBB,68,754,822,0.0827250608272506
1270,NE,LANCASTER,0,3,3,0.0
1271,OR,HOOD RIVER,39,1005,1044,0.03735632183908046
1272,OK,BECKHAM,184,1654,1838,0.10010881392818281
1273,OR,JACKSON,805,7999,8804,0.09143571104043617
1274,ID,JEROME,188,1702,1890,0.09947089947089947
1275,NJ,CAPE MAY,1328,6747,8075,0.16445820433436534
1276,OH,FAYETTE,236,1976,2212,0.10669077757685352
1277,VA,HANOVER,318,4416,4734,0.06717363751584284
1278,NM,EDDY,313,588,901,0.34739178690344064
1279,IL,VERMILION,438,668,1106,0.3960216998191682
1280,SD,BROOKINGS,0,2,2,0.0
1281,ND,GRAND FORKS,54,2299,2353,0.022949426264343393
1282,MI,MONTCALM,254,2481,2735,0.09287020109689213
1283,RI,KENT,10,107,117,0.08547008547008547
1284,GA,COWETA,9,10,19,0.47368421052631576
1285,NC,JACKSON,110,1990,2100,0.05238095238095238
1286,NC,HARNETT,757,7937,8694,0.08707154359328273
1287,IL,BOONE,335,5292,5627,0.059534387773236185
1288,CA,MERCED,1760,15802,17562,0.10021637626693998
1289,VA,AMHERST,119,1283,1402,0.08487874465049929
1290,ME,SAGADAHOC,28,1019,1047,0.026743075453677174
1291,MI,ISABELLA,144,3721,3865,0.037257438551099614
1292,NC,DAVIE,149,2143,2292,0.0650087260034904
1293,MI,MACOMB,1572,2193,3765,0.41752988047808764
1294,NY,BRONX,25051,4180,29231,0.8570011289384557
1295,MI,MARQUETTE,153,3524,3677,0.04161000815882513
1296,MN,BECKER,215,148,363,0.5922865013774105
1297,GA,WARE,34,12,46,0.7391304347826086
1298,NY,CATTARAUGUS,0,5,5,0.0
1299,WI,KENOSHA,955,5054,6009,0.15892827425528375
1300,NJ,BURLINGTON,4339,27695,32034,0.1354498345507898
1301,CA,TULARE,2444,25873,28317,0.0863085778860755
1302,SC,ABBEVILLE,73,974,1047,0.06972301814708691
1303,VA,WAYNESBORO CITY,67,1387,1454,0.04607977991746905
1304,MD,CALVERT,108,1088,1196,0.0903010033444816
1305,VA,NA,2995,33700,36695,0.08161874914838534
1306,FL,OKEECHOBEE,268,2798,3066,0.08741030658838878
1307,SC,ANDERSON,1028,10171,11199,0.09179391017055094
1308,MI,MANISTEE,53,626,679,0.0780559646539028
1309,KY,BELL,146,2246,2392,0.061036789297658864
1310,IN,GRANT,184,1045,1229,0.1497152156224573
1311,IL,MADISON,1141,11607,12748,0.08950423595858174
1312,AL,HOUSTON,176,2448,2624,0.06707317073170732
1313,OH,CHAMPAIGN,150,1859,2009,0.0746640119462419
1314,PA,COLUMBIA,80,1335,1415,0.05653710247349823
1315,IN,ALLEN,656,1765,2421,0.27096241222635276
1316,IN,HENRY,27,698,725,0.037241379310344824
1317,SC,RICHLAND,1490,24116,25606,0.05818948683902211
1318,IN,LAPORTE,126,468,594,0.21212121212121213
1319,MT,NA,1970,22227,24197,0.08141505145265943
1320,AL,FRANKLIN,84,1507,1591,0.05279698302954117
1321,PA,BLAIR,234,2335,2569,0.09108602569093033
1322,OH,PUTNAM,277,2420,2697,0.10270671116054876
1323,SC,BEAUFORT,634,9983,10617,0.059715550532165394
1324,PA,YORK,1417,8534,9951,0.14239774896995278
1325,AL,MOBILE,1416,13487,14903,0.09501442662551164
1326,FL,MARION,1829,16696,18525,0.09873144399460189
1327,PA,WESTMORELAND,1888,6612,8500,0.22211764705882353
1328,NY,LEWIS,3,19,22,0.13636363636363635
1329,NE,DOUGLAS,2,10,12,0.16666666666666666
1330,OK,DELAWARE,239,3020,3259,0.07333537895059834
1331,FL,ST. JOHNS,609,10657,11266,0.05405645304455885
1332,OH,GUERNSEY,254,2652,2906,0.08740536820371644
1333,FL,ALACHUA,712,15352,16064,0.044322709163346616
1334,GA,CHATHAM,355,1081,1436,0.24721448467966572
1335,MA,BRISTOL,1762,7122,8884,0.19833408374606035
1336,IN,GIBSON,32,142,174,0.1839080459770115
1337,GA,POLK,5,7,12,0.4166666666666667
1338,MD,CHARLES,125,736,861,0.14518002322880372
1339,VA,ARLINGTON,859,10283,11142,0.07709567402620715
1340,AR,CRAWFORD,360,4006,4366,0.08245533669262482
1341,OK,CANADIAN,632,9192,9824,0.06433224755700326
1342,AL,JEFFERSON,1653,25932,27585,0.05992387166938554
1343,AL,LEE,213,4268,4481,0.04753403258201294
1344,MI,MONROE,657,5676,6333,0.10374230222643296
1345,GA,HOUSTON,64,171,235,0.2723404255319149
1346,NY,WARREN,18,92,110,0.16363636363636364
1347,OK,MCCLAIN,323,3453,3776,0.08554025423728813
1348,NJ,ESSEX,11993,52260,64253,0.18665276329509906
1349,AZ,YAVAPAI,1767,7809,9576,0.18452380952380953
1350,KY,WOODFORD,89,1902,1991,0.04470115519839277
1351,SC,GREENWOOD,272,3785,4057,0.06704461424698052
1352,KS,ELLIS,168,2886,3054,0.0550098231827112
1353,PA,SCHUYLKILL,398,3328,3726,0.10681696188942566
1354,KY,ALLEN,217,3005,3222,0.06734947237740534
1355,IN,FRANKLIN,42,86,128,0.328125
1356,MD,PRINCE GEORGE'S,1710,2556,4266,0.4008438818565401
1357,MI,IOSCO,90,949,1039,0.08662175168431184
1358,NY,MONTGOMERY,37,228,265,0.13962264150943396
1359,DC,NA,7109,11079,18188,0.3908621068836596
1360,WA,CHELAN,311,6582,6893,0.045118235891484115
1361,KS,MONTGOMERY,141,2431,2572,0.05482115085536547
1362,VA,CULPEPER,181,3155,3336,0.054256594724220626
1363,PA,BUCKS,1643,18824,20467,0.0802755655445351
1364,VA,SCOTT,126,1265,1391,0.0905823148813803
1365,MI,ST. CLAIR,733,6845,7578,0.09672736869886514
1366,VA,PRINCE GEORGE,58,1805,1863,0.031132581857219538
1367,CA,SAN MATEO,398,2159,2557,0.1556511536957372
1368,CO,LOGAN,221,708,929,0.2378902045209903
1369,MS,JACKSON,116,947,1063,0.10912511759172154
1370,PA,BEDFORD,112,1028,1140,0.09824561403508772
1371,AR,HEMPSTEAD,69,884,953,0.07240293809024134
1372,WI,FOND DU LAC,689,8789,9478,0.07269466132095379
1373,PA,ERIE,1167,8211,9378,0.12444017914267434
1374,IL,DEKALB,615,5543,6158,0.0998700876908087
1375,MS,DESOTO,138,1237,1375,0.10036363636363636
1376,AR,CRITTENDEN,383,3445,3828,0.10005224660397075
1377,TN,JEFFERSON,160,1927,2087,0.07666506947771921
1378,PA,LACKAWANNA,692,4592,5284,0.13096139288417866
1379,IN,VANDERBURGH,79,1560,1639,0.04820012202562538
1380,OH,SHELBY,159,1240,1399,0.11365260900643316
1381,VA,GLOUCESTER,62,1398,1460,0.04246575342465753
1382,NC,GASTON,1937,13639,15576,0.12435798664612224
1383,IN,HANCOCK,97,718,815,0.11901840490797547
1384,AZ,MARICOPA,49857,219157,269014,0.18533236188451158
1385,IN,OWEN,5,39,44,0.11363636363636363
1386,AL,BALDWIN,316,5469,5785,0.054624027657735524
1387,NC,HOKE,118,1188,1306,0.0903522205206738
1388,VA,PETERSBURG CITY,172,1733,1905,0.09028871391076115
1389,NC,MECKLENBURG,2493,58475,60968,0.04089030310982811
1390,OH,KNOX,353,2446,2799,0.1261164701679171
1391,AZ,GILA,717,4915,5632,0.12730823863636365
1392,MI,LENAWEE,460,5695,6155,0.07473598700243704
1393,OH,FAIRFIELD,733,8054,8787,0.08341868669625584
1394,KY,SHELBY,136,2407,2543,0.053480141565080616
1395,IN,BARTHOLOMEW,65,502,567,0.1146384479717813
1396,IA,PLYMOUTH,61,1562,1623,0.03758471965495995
1397,LA,NA,1328,4775,6103,0.21759790267081763
1398,PA,ARMSTRONG,121,1053,1174,0.1030664395229983
1399,OK,POTTAWATOMIE,560,5548,6108,0.091683038637852
1400,IN,MORGAN,68,337,405,0.16790123456790124
1401,WI,OZAUKEE,414,2525,2939,0.14086423953725757
1402,PA,ELK,59,909,968,0.060950413223140494
1403,VA,FREDERICKSBURG CITY,101,872,973,0.10380267214799589
1404,NC,CHATHAM,209,2046,2255,0.09268292682926829
1405,ME,PENOBSCOT,228,4605,4833,0.04717566728739913
1406,NC,BRUNSWICK,316,7236,7552,0.04184322033898305
1407,VT,FRANKLIN,50,1691,1741,0.02871912693854107
1408,VA,DANVILLE CITY,291,2111,2402,0.12114904246461282
1409,NY,ROCKLAND,1141,7164,8305,0.13738711619506322
1410,NC,YADKIN,245,2703,2948,0.08310719131614654
1411,AL,ETOWAH,245,2986,3231,0.07582791705354379
1412,FL,LEE,1936,16613,18549,0.1043722033532805
1413,FL,MONROE,194,3922,4116,0.047133138969873666
1414,TN,CUMBERLAND,151,2551,2702,0.05588452997779423
1415,NC,FORSYTH,1779,15478,17257,0.10308860172683548
1416,SC,GEORGETOWN,428,4299,4727,0.09054368521260842
1417,MN,CASS,204,91,295,0.6915254237288135
1418,GA,NEWTON,23,29,52,0.4423076923076923
1419,MN,NA,2439,3549,5988,0.407314629258517
1420,CA,SANTA BARBARA,1207,21125,22332,0.054048002865842736
1421,MN,WASHINGTON,1305,803,2108,0.6190702087286527
1422,VA,MECKLENBURG,90,793,883,0.10192525481313704
1423,TN,DAVIDSON,1888,26092,27980,0.06747676912080057
1424,SC,EDGEFIELD,103,1507,1610,0.06397515527950311
1425,IN,LAKE,1437,2855,4292,0.3348089468779124
1426,WI,MONROE,150,2507,2657,0.05645464809936018
1427,IN,STEUBEN,81,153,234,0.34615384615384615
1428,VA,SHENANDOAH,206,2415,2621,0.07859595574208317
1429,CA,KERN,6541,32718,39259,0.16661147762296544
1430,OH,MEIGS,79,585,664,0.11897590361445783
1431,NY,SULLIVAN,115,680,795,0.14465408805031446
1432,GA,DODGE,15,6,21,0.7142857142857143
1433,OH,HOCKING,142,1497,1639,0.08663819402074435
1434,VA,FAUQUIER,193,3040,3233,0.059696875966594495
1435,MI,LIVINGSTON,499,5375,5874,0.08495062989445012
1436,VA,CHESTERFIELD,1034,16607,17641,0.05861345728700187
1437,OK,CREEK,657,4105,4762,0.1379672406551869
1438,OH,HAMILTON,3252,34793,38045,0.08547772374819293
1439,WI,DOOR,88,498,586,0.15017064846416384
1440,IA,DES MOINES,81,1286,1367,0.0592538405267008
1441,GA,BURKE,10,7,17,0.5882352941176471
1442,TN,HARDEMAN,92,1639,1731,0.05314846909300982
1443,FL,GADSDEN,346,3228,3574,0.09681029658645775
1444,KY,CARTER,86,1974,2060,0.04174757281553398
1445,TN,MAURY,264,6312,6576,0.040145985401459854
1446,PA,INDIANA,190,2037,2227,0.08531656937584194
1447,VA,CARROLL,215,1805,2020,0.10643564356435643
1448,PA,ALLEGHENY,7283,44713,51996,0.14006846680513885
1449,IN,JACKSON,29,964,993,0.02920443101711984
1450,MA,FRANKLIN,170,926,1096,0.1551094890510949
1451,OH,ALLEN,838,8145,8983,0.09328732049426695
1452,IN,MIAMI,89,161,250,0.356
1453,PA,TIOGA,120,681,801,0.149812734082397
1454,TN,PUTNAM,190,4961,5151,0.036886041545331004
1455,NY,NASSAU,2417,5144,7561,0.31966671075254594
1456,ME,NA,150,2546,2696,0.055637982195845696
1457,ND,STARK,56,1184,1240,0.04516129032258064
1458,CA,PLACER,924,10075,10999,0.08400763705791435
1459,NJ,UNION,7841,38518,46359,0.1691365214952868
1460,VT,BENNINGTON,65,1357,1422,0.04571026722925457
1461,WA,DOUGLAS,148,3530,3678,0.04023926046764546
1462,MA,HAMPSHIRE,291,3550,3841,0.0757615204373861
1463,SC,AIKEN,730,9053,9783,0.07461923745272411
1464,MI,WEXFORD,84,1293,1377,0.06100217864923747
1465,UT,CARBON,2,1153,1155,0.0017316017316017316
1466,KY,CLARK,104,1622,1726,0.06025492468134415
1467,IN,SHELBY,198,1409,1607,0.12321095208462975
1468,TN,GREENE,188,2739,2927,0.0642295866074479
1469,IN,JOHNSON,197,790,987,0.19959473150962512
1470,IA,DALLAS,92,2703,2795,0.032915921288014315
1471,AL,SHELBY,299,6611,6910,0.043270622286541244
1472,FL,JACKSON,291,2527,2818,0.10326472675656494
1473,TN,HENDERSON,78,1523,1601,0.04871955028107433
1474,MI,SANILAC,116,1182,1298,0.08936825885978428
1475,PA,NA,395,3335,3730,0.10589812332439678
1476,UT,BOX ELDER,36,5623,5659,0.006361547976674324
1477,OH,HARDIN,152,1767,1919,0.07920792079207921
1478,WA,SPOKANE,2758,44425,47183,0.05845325646949113
1479,PA,FAYETTE,467,2818,3285,0.14216133942161338
1480,IL,FULTON,121,864,985,0.12284263959390863
1481,GA,CAMDEN,4,5,9,0.4444444444444444
1482,HI,NA,0,10,10,0.0
1483,KY,MUHLENBERG,89,2132,2221,0.04007203962179198
1484,WA,WHATCOM,480,9456,9936,0.04830917874396135
1485,CA,EL DORADO,321,4156,4477,0.07169979897252625
1486,AR,CARROLL,120,1817,1937,0.061951471347444505
1487,NM,VALENCIA,437,551,988,0.4423076923076923
1488,GA,HALL,243,1083,1326,0.1832579185520362
1489,OH,TUSCARAWAS,662,5436,6098,0.10856018366677599
1490,TN,KNOX,1107,24658,25765,0.04296526295361925
1491,OH,VAN WERT,90,1753,1843,0.048833423765599564
1492,MD,CAROLINE,33,408,441,0.07482993197278912
1493,PA,UNION,296,1271,1567,0.18889597957881302
1494,PA,PIKE,152,1244,1396,0.10888252148997135
1495,NC,MCDOWELL,143,3776,3919,0.03648890022965042
1496,WI,JACKSON,79,492,571,0.138353765323993
1497,NY,WASHINGTON,64,90,154,0.4155844155844156
1498,MI,CHARLEVOIX,50,1032,1082,0.04621072088724584
1499,OH,MORROW,146,1871,2017,0.07238472979672782
1500,ME,CUMBERLAND,479,12512,12991,0.036871680394119005
1501,NM,GRANT,109,126,235,0.46382978723404256
1502,PA,LEHIGH,1134,16361,17495,0.064818519577022
1503,LA,JEFFERSON,216,510,726,0.2975206611570248
1504,AZ,GRAHAM,308,2017,2325,0.1324731182795699
1505,MT,FLATHEAD,429,9269,9698,0.04423592493297587
1506,OH,WYANDOT,163,1649,1812,0.08995584988962473
1507,KY,WARREN,467,7712,8179,0.05709744467538819
1508,AL,PIKE,40,945,985,0.04060913705583756
1509,MI,OTSEGO,77,1468,1545,0.04983818770226537
1510,IA,DUBUQUE,144,4043,4187,0.034392166228803436
1511,TN,CAMPBELL,106,1190,1296,0.08179012345679013
1512,UT,NA,191,28089,28280,0.006753889674681754
1513,AR,UNION,124,1807,1931,0.06421543241843604
1514,MI,HILLSDALE,173,2514,2687,0.06438407145515444
1515,OK,CADDO,266,2716,2982,0.0892018779342723
1516,NC,LENOIR,469,3394,3863,0.12140823194408491
1517,NY,BROOME,85,479,564,0.15070921985815602
1518,MO,ST. LOUIS,7,4,11,0.6363636363636364
1519,VA,ROANOKE CITY,263,3917,4180,0.06291866028708135
1520,VA,HOPEWELL CITY,106,1106,1212,0.08745874587458746
1521,WI,MILWAUKEE,4915,38976,43891,0.11198195529835274
1522,OR,MARION,1371,14859,16230,0.0844731977818854
1523,AL,CALHOUN,224,2874,3098,0.07230471271788251
1524,IA,POTTAWATTAMIE,238,3212,3450,0.06898550724637681
1525,IN,HUNTINGTON,23,68,91,0.25274725274725274
1526,GA,OCONEE,22,44,66,0.3333333333333333
1527,GA,LIBERTY,40,38,78,0.5128205128205128
1528,CO,NA,1736,12552,14288,0.12150055991041434
1529,TN,LOUDON,116,2059,2175,0.05333333333333334
1530,SC,SPARTANBURG,2280,19512,21792,0.10462555066079295
1531,OH,UNION,219,2919,3138,0.06978967495219886
1532,IA,WASHINGTON,73,707,780,0.09358974358974359
1533,PA,SUSQUEHANNA,127,941,1068,0.11891385767790262
1534,SC,DILLON,267,2957,3224,0.08281637717121589
1535,GA,GRADY,69,130,199,0.34673366834170855
1536,TX,COLLIN,0,7,7,0.0
1537,MO,NA,61,295,356,0.17134831460674158
1538,TX,NA,71,274,345,0.20579710144927535
1539,MI,ST. JOSEPH,146,3714,3860,0.03782383419689119
1540,KY,OHIO,62,1389,1451,0.042729152308752585
1541,NC,DURHAM,818,18585,19403,0.042158429108900684
1542,NC,MONTGOMERY,242,2519,2761,0.08764940239043825
1543,TN,RUTHERFORD,568,12674,13242,0.042893822685394954
1544,VA,LYNCHBURG CITY,321,3316,3637,0.08825955457794886
1545,GA,WHITE,35,80,115,0.30434782608695654
1546,SD,CODINGTON,0,1,1,0.0
